中	a
丨	aa
步步	aaaa
紧紧	aaaa
止步	aaaa
监督	aaah
篮	aaam
监管	aaax
凿	aaba
黹	aabb
黻	aabd
黼	aabd
筛分	aabd
邺	aabe
业	aabh
紧迫	aabz
频带	aaca
临摹	aacr
紧急	aadi
笊	aadn
鉴于	aaeg
频率	aaew
览	aafg
临	aafh
鉴	aafj
监	aafm
频繁	aafm
坚强	aagk
临床	aagm
紧张	aagv
止	aaha
坚韧	aahh
舻	aaho
贤惠	aahr
业绩	aajh
紧缩	aajx
临近	aajz
鉴别	aakl
坚固	aako
竖立	aald
坚毅	aalp
紧凑	aals
坚决	aalw
步骤	aame
监禁	aamm
步枪	aamr
监查	aamr
坚硬	aaoh
监视	aaok
紧接	aaol
步履	aaop
坚持	aaot
步兵	aapa
频	aapb
筛	aapj
颦	aapo
步	aapp
步行	aapr
监狱	aaqy
临时	aarc
业余	aare
步伐	aarg
坚信	aary
监测	aasb
步法	aast
临界	aatr
肾脏	aaug
篮球	aawh
业已	aawh
业务	aawl
坚守	aaxc
坚实	aaxd
紧密	aaxd
坚定	aaxh
鉴定	aaxh
监牢	aaxn
紧要	aaxn
鉴赏	aaxt
监察	aaxx
贤	aayb
紧	aayj
竖	aayl
步调	aayp
坚	aayt
肾	aayu
步子	aazw
篮子	aazw
筛子	aazw
凿子	aazw
此	ab
雌	abat
舭	abbd
筚	abbo
赀	abbt
雌蕊	abcx
箭头	abdd
笆	abdg
舶	abdh
觜	abdo
些	abet
此刻	abew
箭	abhd
此事	abhk
艏	abhm
背道而驰	abhm
此致	abhs
紫红	abjg
紫	abjt
簖	abmj
篓	abmn
此间	abmr
柴	abmt
爬	abng
雌雄	abos
砦	abot
篼	abpe
此后	abpp
爬行	abpr
此时	abrc
箪	abro
柴油	absk
此	abtg
此地	abtg
此处	abwa
篁	abwd
此外	abxa
訾	abyt
簧	ac
虢	acaj
簧	achb
箬	acok
箕	acsb
簸	acsy
艨	actn
卜	ad
舣	adid
筝	adig
篇幅	adjh
笱	adkd
笤	adkd
篇章	adlr
篇	adoc
笏	adpp
北	ae
篱笆	aeab
竿	aead
北非	aeas
北	aeb
冀	aebb
背叛	aebe
航道	aebh
背	aebu
竺	aedh
北大	aedh
背包	aeds
背离	aeei
北京市	aeej
北京	aeek
航天	aeer
航运	aees
北方	aefd
笺	aegd
竽	aegd
邶	aehe
航速	aehk
背面	aehp
篱	aeis
航	aejd
航线	aeje
北风	aeji
篙	aekk
北国	aekw
北部	aelk
背部	aelk
北京新天地	aelt
北边	aelz
航标	aemo
北极	aemp
航向	aepk
北魏	aepm
航程	aepm
背后	aepp
航行	aepr
集市贸易	aepr
爰	aepy
背景	aere
背影	aere
北海	aesf
航海	aesf
舷	aews
背心	aexd
航空	aexg
北宋	aexm
背诵	aeyw
簇	af
笮	afae
筅	afae
舴	afae
舫	afdg
遥远	afee
遥望	afeg
簇	affd
鹞	afnp
簇拥	afou
遥控	afox
繇	afpj
遥测	afsb
笙	aftd
遥	afzp
第	ag
第	agap
第八	agbp
舡	agdh
第六	ageb
筇	aged
第二	ageh
第五	agha
第一	aghh
笥	aghk
坚强不屈	agho
筑	agjd
第十	agoh
第九	agpg
隽	agph
第七	agqh
第四	agsa
第三	agsh
簏	agwb
上	ah
凸	ahah
筮	ahah
餐桌	ahah
点点	ahah
焦点	ahah
焦虑	ahah
叔叔	ahah
芈	ahao
上等	ahat
篚	ahaw
贞	ahb
上前	ahbh
战前	ahbh
战败	ahbw
篝	ahct
虚荣	ahct
上学	ahdb
点头	ahdd
上头	ahdd
战斗	ahdd
劁	ahdh
焦急	ahdi
战争	ahdi
上旬	ahdr
上帝	aheb
上交	aheb
焦耳	aheh
上市	ahej
上进	ahep
上天	aher
策动	ahes
点阵	ahev
上年	ahfh
上午	ahfo
虚度	ahgc
虞	ahgd
策划	ahgd
策应	ahgd
觑	ahgg
虚	ahgh
虎	ahgj
虏	ahgl
虚弱	ahgl
彪	ahgp
上皮	ahgp
虍	ahgq
虐	ahgw
虔	ahgw
虑	ahgx
遽	ahgz
上	ahh
上下	ahha
上来	ahhb
焦	ahhd
卡	ahhd
点火	ahhd
上火	ahhd
战火	ahhd
点灯	ahhh
战事	ahhk
督	ahhm
上面	ahhp
上万	ahhp
桌面	ahhp
箧	ahhw
忐	ahhx
点燃	ahhx
上列	ahhx
叔	ahhy
上衣	ahid
策	ahjb
上缴	ahjb
卓绝	ahjd
虚线	ahje
战线	ahje
上风	ahji
上级	ahjp
点缀	ahjy
占	ahk
虎口	ahka
焦距	ahka
焦躁	ahka
籁	ahkb
战	ahkg
乩	ahkg
觇	ahkg
舸	ahkg
鹾	ahkg
点	ahkh
卤	ahkh
卣	ahkh
簌	ahkq
艚	ahkr
笸	ahkw
战国	ahkw
上将	ahla
上浆	ahla
上装	ahla
督办	ahlb
上部	ahlk
上次	ahlq
上边	ahlz
上门	ahmd
上述	ahmd
虚构	ahmd
战术	ahmd
上相	ahmm
上马	ahmw
战马	ahmw
鹪	ahnh
上好	ahnz
卢	aho
上山	ahoa
颅	ahob
上报	ahoe
上层	ahoe
虚拟	ahog
战士	ahoh
卢布	ahoj
鸬	ahon
焦炭	ahoo
占据	ahoo
点播	ahop
上身	ahop
餐饮	ahoq
占有	ahou
餐馆	ahox
战友	ahoy
豳	ahpa
卡片	ahpa
上升	ahpc
战后	ahpp
虐待	ahpr
上街	ahpr
上行	ahpr
战役	ahpr
战时	ahrc
虚伪	ahrd
占领	ahrd
筻	ahri
督促	ahrk
卓	ahrm
桌	ahrm
上体	ahrm
上任	ahrp
虚假	ahrw
上流	ahse
上海	ahsf
上游	ahsf
上水	ahsg
上涨	ahsg
上台	ahsk
上演	ahsx
箦	ahtb
上场	ahtg
战场	ahtg
睿	ahtm
上去	ahts
壑	ahtt
箐	ahtu
策略	ahtw
战略	ahtw
占用	ahua
战胜	ahuf
上肢	ahuo
餐厅	ahvh
卡车	ahvh
凸轮	ahvr
点出	ahwa
凸出	ahwa
上班	ahwd
上文	ahwd
上书	ahwg
簪	ahwr
战备	ahwt
筐	ahww
点心	ahxd
虚心	ahxd
上空	ahxg
上当	ahxi
点名	ahxk
粲	ahxm
餐	ahxo
攴	ahy
上诉	ahyj
上课	ahyr
上谕	ahyr
卓越	ahzh
点子	ahzw
桌子	ahzw
笋	ai
箫	aiab
笋	aidp
簋	aigm
船	aj
船舶	ajab
船舷	ajae
船舱	ajar
艘	ajay
船头	ajdd
船队	ajer
船夫	ajer
船工	ajgh
船员	ajkb
船只	ajkb
船	ajkd
舀	ajph
船体	ajrm
船长	ajvp
般	ajyd
磐	ajyo
筒	ak
篑	akab
舯	akad
舰艇	akap
笄	akda
爱国主义	aked
舰队	aker
售	akhh
筒	akhk
坚固耐用	akhu
洄	akkh
笛	akoh
舳	akoh
舰	akpg
觅	akpg
笕	akpg
售货	akrq
售价	akrr
洄游	aksf
非同小可	akxh
笛子	akzw
筒子	akzw
笠	aldh
笳	alkd
艟	alrt
北冰洋	alsy
笾	alzd
算	am
采集	amam
盘算	amam
算盘	amam
采购	ambd
简单	ambr
彩带	amca
算	amcd
彩色	amdb
篡夺	amdc
笔	amdg
盘	amdh
笃	amdh
纂	amdj
篡	amds
简陋	ameh
集市	amej
笔迹	amep
彩云	ames
采取	amey
简短	amfd
彩旗	amff
盘旋	amff
笔下	amha
笨	amhd
归根到底	amhg
彩灯	amhh
集	amhn
集约	amjd
采纳	amjk
集结	amjo
集镇	amjo
彩绘	amjr
算帐	amjv
篡改	amjw
集中	amka
笔墨	amkb
集团	amkh
简朴	amma
箱	ammd
算术	ammd
盘问	ammk
采样	ammy
集权	ammy
彩排	amoa
采摘	amoe
简报	amoe
采矿	amog
简捷	amoh
笔直	amok
简直	amok
采掘	amoo
笨拙	amow
彩印	ampg
笨重	amph
采种	ampm
简称	ampm
采	ampn
彩	ampp
算得	ampr
采暖	amra
简	amrd
简易	amrd
集会	amre
采伐	amrg
彩电	amrg
集合	amrh
简便	amrh
算是	amrh
集体	amrm
简介	amrp
简化	amrq
简明	amru
简洁	amso
算法	amst
简写	amth
简略	amtw
采用	amua
彩霞	amuw
彩虹	amvg
集成	amvg
笔录	amwe
算了	amwg
笔尖	amxd
简要	amxn
简谱	amyb
采访	amyf
简讯	amyg
笔试	amyh
笔记	amyj
算计	amyo
笔调	amyp
盘子	amzw
箱子	amzw
妥	an
妥协	anol
妥	anph
妥当	anxi
妥善	anyb
歧	ao
筢	aobd
箝	aoce
舢	aoda
笼	aogd
隼	aoha
箍	aohw
坚持不懈	aohx
上层建筑	aoia
笼统	aoje
筘	aokd
艉	aomd
歧视	aook
籀	aopt
笼罩	aosa
箨	aoyo
歧	aoyt
笼子	aozw
笑	ap
隹	apad
竹竿	apae
筵	apaz
师范	apcs
笑	apdd
归于	apeg
师生	apft
归功	apgl
笫	apgp
竹	apha
师	aphj
归还	aphr
爪牙	aphw
归	api
归纳	apjk
归结	apjo
篦	apkb
归国	apkw
师资	aplq
竹林	apmm
师母	apmw
师雄	apos
艇	apoz
爪	appa
舟	appg
篪	appj
舨	appy
师傅	aprh
笑脸	apur
师长	apvp
笈	apwn
归宿	apxr
笑容	apxr
笑话	apyp
竹子	apzw
爪子	apzw
旧	ar
筱	araw
答卷	arbe
符	arcd
渴	ardw
背信弃义	ared
集体主义	ared
渴望	areg
旧制	arfh
答复	arfr
筏	argd
答应	argd
舱	argg
旧	arh
笪	arhd
签	arhh
答	arhk
旧事	arhk
售货员	arkb
符号	arkh
答辩	arlo
答问	armk
集体所有制	arpf
答题	arrh
符合	arrh
舱位	arrl
签署	arst
涅	artt
旧历	arvl
齿轮	arvr
齿	arwa
龀	arwb
龇	arwb
龄	arwd
龋	arwd
筌	arwd
篌	arwd
齿条	arwh
龆	arwk
龉	arwk
龈	arwn
签发	arwp
龊	arwr
答理	arwr
龃	arws
龅	arws
龌	arwt
签定	arxh
签名	arxk
答案	arxn
签字	arxz
答对	aryc
答词	aryg
签订	aryh
签证	aryh
答谢	aryo
答话	aryp
非	as
酆	asae
韭	asah
箩筐	asah
裴	asai
翡	asal
筹集	asam
籍	asar
非	asas
辈	asav
蜚	asav
斐	asaw
悲	asax
箔	asbd
辈分	asbd
上海市	asej
悲哀	asek
筹划	asgd
悲痛	asgl
簿	ashc
爵	asic
筹建	asie
笞	askd
悲壮	asla
第三产业	asla
筹办	aslb
筹措	asoc
悲剧	asoo
筹	aspc
悲伤	asrf
非人	asrp
非但	asrr
非洲	assd
非法	asst
篾	asvd
翡翠	aswl
筹备	aswt
籍贯	asww
箩	asxd
悲愤	asxo
悲惨	asxs
非常	asxt
悲观	asyk
等	at
等分	atbd
受益	atbh
受精	atbm
等	atcd
受苦	atco
爱慕	atcr
筠	atdl
等角	atdu
等效	ateb
等于	ateg
集思广益	atgb
箅	atha
等式	athg
等到	aths
受到	aths
等级	atjp
等号	atkh
等同	atkh
爱国	atkw
等次	atlq
爱好	atnz
爱护	atod
爱抚	atoe
受热	atop
爱	atoy
箸	atpr
等待	atpr
等候	atra
受伤	atrf
受命	atrh
爱人	atrp
等价	atrr
受罪	atsa
受潮	atso
等温	atsr
受累	attj
爱戴	attt
等腰	atux
爱民	atwh
受理	atwr
舜	atxa
爱憎	atxb
爱惜	atxc
受惊	atxe
爱情	atxh
受害	atxs
受	atyp
肯	au
肯	auhh
筋	auld
肯定	auxh
箴	avhd
集成电路	avrk
凹	aw
兕	awae
凹	awah
凹凸	awah
奚落	awcs
簦	awdd
凹陷	awed
业务联系	awep
幽静	awht
幽灵	awih
幽默	awkb
幽闲	awmm
幽	awsa
奚	awsd
篷	awsz
篆	awwn
管	ax
舵	axbd
管道	axbh
管带	axca
舾	axdh
管制	axfh
箜	axgd
管事	axhk
坚定不移	axhp
管路	axka
篥	axmd
鉴定会	axre
簟	axro
管教	axtp
管用	axua
筲	axud
艄	axud
管辖	axvx
筷	axwd
管	axwh
管理	axwr
箢	axxg
管家	axxh
管子	axzw
筷子	axzw
雠	ayah
妥善处理	ayww
郛	azep
乳	azgp
艋	azmd
孚	azph
乳剂	azwp
乳酸	azys
不	b
贴	ba
贝类	babm
丫头	badd
精简整编	bahj
贴	bahk
丫	bap
贝	bawp
贴心	baxd
比	bb
毕业	bbaa
赠送	bbbe
皆	bbbg
庇	bbbp
毖	bbdd
养精畜锐	bbej
婴儿	bbep
比率	bbew
罂	bbfd
比方	bbfd
毕生	bbft
比	bbgg
毙	bbhb
赚	bbhb
精益求精	bbhb
赠	bbkr
比喻	bbkr
毕竟	bblr
婴	bbnd
比如	bbnk
鹦	bbnn
庇护	bbod
毕	bbog
比拟	bbog
分道扬镳	bboj
比热	bbop
比重	bbph
魄	bbps
比例	bbrh
比值	bbro
比价	bbrr
比较	bbve
普普通通	bbww
比赛	bbxh
总的说来	bbyh
公共汽车	bcsv
分	bd
分歧	bdao
分类	bdbm
分米	bdbm
分数	bdbm
贫	bdbn
赡养	bdbs
分寸	bdch
分散	bdch
贫苦	bdco
分期	bdcs
分头	bddd
则	bddg
的	bddh
分解	bddu
分离	bdei
兰州市	bdej
郑州市	bdej
分享	bdek
分院	bdex
购买	bdgd
分工	bdgh
颁	bdhb
分区	bdhi
分裂	bdhx
分红	bdjg
分组	bdjk
分级	bdjp
购销	bdjx
岔路	bdka
分路	bdka
分号	bdkh
分开	bdkh
分别	bdkl
贫困	bdkm
分立	bdld
分辨	bdlo
分辩	bdlo
分析	bdmj
盆	bdmn
分母	bdmw
分档	bdmx
分	bdnp
分批	bdob
的确	bdod
分局	bdog
皋	bdoh
颁布	bdoj
分布	bdoj
翱	bdol
岔	bdon
分居	bdoo
分手	bdop
分担	bdor
分支	bdoy
贫乏	bdpd
分得	bdpr
分行	bdpr
分会	bdre
分量	bdrh
分化	bdrq
分明	bdru
购	bdsd
分泌	bdsd
分清	bdsh
购置	bdso
分地	bdtg
盆地	bdtg
贫农	bdti
坌	bdtn
分界	bdtr
分成	bdvg
赡	bdvy
贫民	bdwh
颁发	bdwp
分发	bdwp
分外	bdxa
贫穷	bdxl
忿	bdxn
分割	bdxs
翱翔	bdyg
分配	bdyj
分子	bdzw
关	be
赋	bead
卷筒	beak
半	beap
皎	bebi
半数	bebm
判断	bebm
关节	becg
关头	bedd
拳头	bedd
郑州	bedp
送达	bedz
叛变	beea
关联	beeb
送交	beeb
关于	beeg
拳击	beeo
半天	beer
半夜	beer
半年	befh
八进制	befh
贱	begd
半百	behb
卷烟	behk
卷绕	bejh
关键	beji
半路	beka
关中	beka
卷曲	bekc
半圆	bekk
判别	bekl
送别	bekl
半音	belr
判决	belw
关门	bemd
关闭	bemh
送礼	beog
眷属	beop
判	bepd
半岛	bepg
誊印	bepg
郑重	beph
关系	bepj
赋税	bepm
关税	bepm
卷入	bepn
送入	bepn
叛乱	bepo
半径	bepr
叛徒	bepr
送行	bepr
叛	bepy
关切	beqd
半个	bera
豢	berd
券	berd
关照	berd
郑	bere
卷	berg
判例	berh
眷	berm
桊	berm
拳	bero
关	berp
半晌	berp
鲞	beru
誊	bery
送	berz
关注	bese
半夜三更	besh
半截	beta
判处	bewa
赋予	bewd
半球	bewh
赅	bewr
关心	bexd
关怀	bexh
判定	bexh
疑	bf
疑虑	bfah
皓	bfak
疑义	bfdi
肄	bfdo
疑	bfdr
疑惑	bfhk
疑问	bfmk
敫	bfwh
邀	bfwz
疑心	bfxd
疑难	bfya
邀请	bfyh
弟	bg
剃	bgad
鹈	bgan
弟	bgap
递	bgaz
递送	bgbe
弟弟	bgbg
递交	bgeb
递进	bgep
弟兄	bgke
递减	bglv
赃物	bgnd
递推	bgoa
赃款	bgos
总工会	bgre
递增	bgtb
赃	bgtd
弟子	bgzw
前	bh
道上	bhah
歉虚	bhah
普	bhar
前辈	bhas
慈爱	bhat
兼管	bhax
道歉	bhbh
兼并	bhbk
益	bhbm
塑料	bhbm
蠲	bhbv
前期	bhcs
前头	bhdd
剪刀	bhdg
道义	bhdi
财政危机	bhdm
普遍	bhdo
迫不急待	bhdp
兼职	bhek
前进	bhep
前天	bher
财主	bhet
普选	bhfa
首先	bhfa
塑造	bhfa
前方	bhfd
前年	bhfh
前卫	bhga
赇	bhgd
兮	bhgn
财	bhgp
首府	bhgr
财政	bhha
前来	bhhb
赕	bhhd
前面	bhhp
前列	bhhx
兼	bhib
鹣	bhin
歉	bhiq
前线	bhje
财经	bhjw
前锋	bhjw
道路	bhka
财团	bhkh
前哨	bhkx
财力	bhlg
财政部	bhlk
财产	bhlp
首次	bhlq
前边	bhlz
首相	bhmm
剪毛	bhmp
普查	bhmr
财权	bhmy
财物	bhnd
贼	bhod
首饰	bhof
首届	bhok
首尾	bhom
前身	bhop
前提	bhor
慈祥	bhoy
顷	bhpb
馘	bhpd
财贸	bhpg
首	bhpm
前程	bhpm
前后	bhpp
前所	bhpp
道德	bhpr
前往	bhpr
夔	bhpw
普及	bhpw
道	bhpz
遂	bhpz
剪切	bhqd
首领	bhrd
塑像	bhrd
前景	bhre
前途	bhre
首创	bhrg
首位	bhrl
兼任	bhrp
前人	bhrp
逆流	bhse
前沿	bhsj
总政治部	bhsl
财源	bhsv
前者	bhtp
首都	bhtp
前去	bhts
蜻	bhtu
数不胜数	bhub
赙	bhuc
剪	bhud
前	bhud
首脑	bhue
煎	bhuh
翦	bhul
益虫	bhva
兼顾	bhvg
首长	bhvp
蜻蜓	bhvp
益处	bhwa
普通	bhwd
财务	bhwl
槊	bhwm
鹚	bhwn
道理	bhwr
兹	bhws
塑	bhwt
朔	bhwu
八面玲珑	bhww
慈	bhwx
逆	bhwz
孳	bhwz
塑性	bhxf
财富	bhxh
道家	bhxh
逆光	bhxh
首要	bhxn
前夕	bhxp
兼容	bhxr
前额	bhxw
前言	bhyd
总而言之	bhyd
逆差	bhyg
道谢	bhyo
爸	bi
爸	bibd
爸爸	bibi
爹爹	bibi
爷爷	bibi
斧头	bidd
父	bidn
釜	bieh
爷	biga
斧	bijd
父亲	bilh
父本	bimh
父母	bimw
爹	bixx
父子	bizw
帛	bjha
总结经验	bjjm
总经理	bjwr
总	bk
总督	bkah
总算	bkam
总管	bkax
总数	bkbm
总共	bkch
并举	bkdb
并肩	bkdo
总之	bkdw
并联	bkeb
贶	bked
兑	bkep
并进	bkep
总政	bkha
瓶	bkhd
美中不足	bkhk
并不	bkhr
并列	bkhx
总统	bkje
总纲	bkjk
总结	bkjo
曾经	bkjw
并且	bkks
总办	bklb
总部	bklk
总机	bkmj
并存	bkoa
并排	bkoa
兑换	bkod
总局	bkog
总括	bkop
总支	bkoy
并	bkpa
总兵	bkpa
并重	bkph
总称	bkpm
总和	bkpm
并入	bkpn
总后	bkpp
并行	bkpr
前因后果	bkpr
总会	bkre
总量	bkrh
总是	bkrh
总体	bkrm
总值	bkro
总参	bksd
总能	bksu
总裁	bkti
总成	bkvg
总长	bkvp
兑现	bkwk
总务	bkwl
迸发	bkwp
并发	bkwp
总理	bkwr
甑	bkxd
总	bkxp
曾	bkxr
总额	bkxw
总评	bkyh
总计	bkyo
迸	bkzp
瓶子	bkzw
赔	bl
断章取义	bled
赔	blkd
赔礼	blog
赔款	blos
赔偿	blrx
痹	blta
并驾齐驱	blwm
数	bm
粘	bmak
粉笔	bmam
精彩	bmam
精简	bmam
粘贴	bmba
粉	bmbd
断送	bmbe
糕	bmbh
粗糙	bmbm
迷糊	bmbm
糖类	bmbm
糟糕	bmbm
糟粕	bmbm
粕	bmbp
粑	bmbp
糍	bmbs
精美	bmbw
粪	bmcb
粮草	bmcr
数学	bmdb
断头	bmdd
料斗	bmdd
粗大	bmdh
粮	bmdn
料	bmdo
类	bmdp
粹	bmeo
精选	bmfa
迷失	bmfd
精制	bmfh
糙	bmfz
精度	bmgc
粒度	bmgc
糖	bmgk
糠	bmgn
糈	bmgu
糨	bmgv
精炼	bmhh
粳	bmhi
迷惑	bmhk
粉末	bmhm
断面	bmhp
糟	bmhr
精致	bmhs
料到	bmhs
精	bmhu
断裂	bmhx
数列	bmhx
断绝	bmjd
粉红	bmjg
粗细	bmjt
精细	bmjt
断路	bmka
糟蹋	bmka
类型	bmkd
断开	bmkh
类别	bmkl
粗	bmks
粗壮	bmla
粉状	bmla
粒状	bmla
精力	bmlg
粒	bmlp
数目	bmma
料想	bmmm
娄	bmnp
数	bmnw
类推	bmoa
精确	bmod
断层	bmoe
粉碎	bmoe
粉饰	bmof
精矿	bmog
粉刷	bmoj
数码	bmom
数据	bmoo
籼	bmop
粮食	bmop
精神	bmor
糊	bmou
米	bmpn
糗	bmpq
粗犷	bmqg
粗暴	bmrc
糇	bmrd
断电	bmrg
类似	bmrg
粮仓	bmrg
数量	bmrh
数位	bmrl
糖果	bmrm
数值	bmro
精华	bmrq
粗野	bmrt
迷信	bmry
精液	bmse
糁	bmsp
糊涂	bmsr
迷漫	bmsr
粗沙	bmsx
料酒	bmsy
精盐	bmta
粗略	bmtw
糯	bmua
粗鲁	bmur
迷雾	bmuw
粝	bmvg
数轴	bmvk
精通	bmwd
断	bmwj
糅	bmwm
敉	bmwp
糌	bmwr
料理	bmwr
粗心	bmxd
断然	bmxd
精密	bmxd
精心	bmxd
断定	bmxh
粽	bmxo
粞	bmxp
粗劣	bmxp
粉尘	bmxt
粼	bmxw
数额	bmxw
遴	bmxz
数字	bmxz
断言	bmyd
数论	bmyr
迷	bmzp
籽	bmzp
精子	bmzw
粒子	bmzw
料子	bmzw
赎	bo
贿赂	bobw
公有制	bofh
赎	bogd
数据库	bogv
首屈一指	boho
精神焕发	bohw
精打细算	boja
皑	bojh
赆	bond
鸨	bong
贿	boud
精神文明	bowr
数据处理	boww
八	bp
白点	bpah
兜售	bpak
白	bpaw
白米	bpbm
白糖	bpbm
白白	bpbp
皤	bpbt
白菜	bpca
总后勤部	bpcl
白色	bpdb
贬义	bpdi
贬	bpdn
前所未有	bpeo
白天	bper
八旗	bpff
匕	bpg
魃	bpgd
兜	bpge
魅	bpgm
魁	bpgo
魉	bpgr
鬼	bpgs
魑	bpgs
魈	bpgu
魍	bpgw
白银	bpji
白纸	bpjp
卑鄙	bpko
魁梧	bpma
颖	bpmb
白杨	bpmg
八	bpn
白磷	bpob
郫	bpoe
贩卖	bpog
卑	bpoh
白布	bpoj
鹎	bpon
白昼	bpon
鬼神	bpor
贩	bppy
皈	bppy
贬值	bpro
白人	bprp
贬低	bprp
白酒	bpsy
八月	bpup
鬼脸	bpur
八成	bpvg
白发	bpwp
卑劣	bpxp
八字	bpxz
白话	bpyp
皂	bq
皂	bqhg
雁	brap
单数	brbm
单单	brbr
糊里糊涂	brbs
单薄	brcs
单色	brdb
赐	brdp
单干	brea
单元	bree
欲望	breg
赊	brex
旨	brgh
单项	brgh
半途而废	brhg
单一	brhh
单纯	brjh
赊销	brjx
谷	brkd
鹆	brkn
欲	brkq
单产	brlp
单杠	brmg
谷物	brnd
郸	broe
单打	broh
冁	bron
单	brop
单向	brpk
单独	brqv
单位	brrl
单体	brrm
单价	brrr
谷地	brtg
赐予	brwd
单字	brxz
单词	bryg
单调	bryp
单子	brzw
谷子	brzw
公	bs
公分	bsbd
养分	bsbd
公道	bsbh
公顷	bsbh
公益	bsbh
养料	bsbm
公共	bsch
兰花	bscr
兰州	bsdp
公干	bsea
公元	bsee
养育	bses
公主	bset
公告	bsfa
公司	bsgh
翁	bsgl
养病	bsgl
公费	bsgp
公正	bsha
颂	bshb
颍	bshb
公平	bshb
瓮	bshd
公式	bshg
公事	bshk
泉	bshn
养殖	bshx
公约	bsjd
公斤	bsjp
公路	bska
贻	bskd
公园	bske
公开	bskh
公章	bslr
泉眼	bsmi
公	bsnd
公物	bsnd
公报	bsoe
颂扬	bsog
公布	bsoj
公尺	bson
公款	bsos
公社	bsot
公有	bsou
公馆	bsox
公升	bspc
羌	bspg
兰	bsph
公私	bspm
养	bsra
公仆	bsra
公使	bsrh
公债	bsrh
半导体	bsrm
公众	bsrr
公里	bsrt
公海	bssf
泉水	bssg
养活	bssp
公法	bsst
兰考	bstp
公用	bsua
养成	bsvg
公厘	bsvr
养蜂	bsvw
公文	bswd
公民	bswh
公务	bswl
公理	bswr
公然	bsxd
公家	bsxh
公安	bsxn
公案	bsxn
恙	bsxp
公审	bsxr
公害	bsxs
公证	bsyh
公诉	bsyj
总参谋部	bsyl
公认	bsyr
公子	bszw
兽	bt
兽医	bthf
兽	bthk
赌咒	btkk
赌博	btoh
赌	btpr
赌气	btqp
账	bv
账簿	bvas
账单	bvbr
账	bvdn
账户	bvdo
赈	bven
账号	bvkh
账目	bvma
账本	bvmh
美	bw
巴	bwah
皇上	bwah
败类	bwbm
羡慕	bwcr
美学	bwdb
败	bwdn
美	bwdp
皇帝	bweb
美元	bwee
皇族	bwff
羹	bwhd
皇	bwhh
美丽	bwhk
羔	bwhp
巴结	bwjo
赂	bwkd
美国	bwkw
羡	bwlq
美术	bwmd
盖	bwmp
皇权	bwmy
姜	bwnp
美女	bwnw
美妙	bwnx
美好	bwnz
败局	bwog
皇朝	bwor
羲	bwpd
巴黎	bwpm
皇后	bwpp
美德	bwpr
败仗	bwro
美人	bwrp
美化	bwrq
数理化	bwrq
美满	bwsc
美洲	bwsd
败坏	bwth
美感	bwvh
巴西	bwxh
皇家	bwxh
皇室	bwxh
美容	bwxr
巴掌	bwxt
羔羊	bwyd
总书记	bwyj
美观	bwyk
普通话	bwyp
遑	bwzh
盖子	bwzw
贮	bx
贮藏	bxcv
皖	bxee
贮	bxhd
公安部	bxlk
贮存	bxoa
公安局	bxog
贮备	bxwt
尊	by
尊敬	bycd
尊	bycp
奠基	bycs
遵	bycz
奠	bydp
尊严	byha
酋	byph
尊重	byph
遵循	bypr
猷	byqp
遵照	byrd
遵守	byxc
奠定	byxh
遒	byzp
迫	bz
迫	bzhn
迫切	bzqd
迫使	bzrh
迫害	bzxs
从	c
卅	caa
芷	caah
萑	caah
蓝	caam
茈	caba
菜单	cabr
菲薄	cacs
蓝色	cadb
带头	cadd
菜刀	cadg
蓝天	caer
带动	caes
蕉	caha
带来	cahb
苫	cahk
菽	cahy
蘧	cahz
菜肴	caio
带路	caka
营业员	cakb
蓝图	cakw
菜	cama
荽	cana
带领	card
带电	carg
菲	cass
菜场	catg
菜地	catg
带	catj
带劲	cawd
菜谱	cayb
劐	cayd
莩	caza
芬	cb
芭	cbag
芘	cbba
葩	cbba
蒈	cbbb
荜	cbbo
芬兰	cbbs
芬芳	cbcf
芭蕾	cbcu
芬	cbda
蒹	cbhb
蒴	cbhu
蒌	cbmn
薮	cbmw
蔸	cbpe
萆	cbpo
蕲	cbrj
蓊	cbsl
恭恭敬敬	cccc
落落大方	ccdf
苷	ccea
勤勤恳恳	ccii
蓬蓬勃勃	ccoo
莫斯科	ccpm
蒸蒸日上	ccra
萁	ccsb
葚	ccsw
敬	cd
敬爱	cdat
菊	cdbm
葡萄	cdcd
芦苇	cdch
菊花	cdcr
芍	cdda
警觉	cddb
萄	cdfa
警告	cdfa
警卫	cdga
芦席	cdgc
苞	cdgg
芝麻	cdgm
警戒	cdhc
葡	cdhd
莨	cdin
萏	cdja
劳逸结合	cdjr
苟	cdka
苕	cdka
菟	cdkd
檠	cdkm
擎	cdko
敬	cdkw
警	cdky
敬意	cdlr
芦	cdoa
萘	cdoa
警报	cdoe
敬礼	cdog
敬重	cdph
芴	cdpp
葱	cdpx
荀	cdra
敬佩	cdrj
敬仰	cdrp
芝	cdwn
警惕	cdxr
警察	cdxx
某	ce
某些	ceab
苄	cead
甘	ceah
茸	ceah
蒡	cebf
茭	cebi
蒂	cebj
甘蓝	ceca
荒芜	cece
甘蔗	cecg
劳动节	cecg
若无其事	cech
甘苦	ceco
甘薯	cecs
芙蓉	cecx
邯	ceea
芫	ceea
芋	cega
荒唐	cegi
劳动致富	cehx
甘肃	ceia
蓠	ceis
劳动纪律	cejp
葶	cekg
蓑	ceki
蒿	cekk
藁	cekm
荒凉	cele
劳动力	celg
萨	celp
蓄意	celr
某	cema
劳动模范	cemc
荒山	ceoa
芜	cepg
蓄积	cepm
芙	cera
劳动保险	cere
劳动量	cerh
萃	cero
某人	cerp
劳动人民	cerw
芸	cesa
茺	cese
蓄水	cesg
甘油	cesk
荒地	cetg
劳动者	cetp
荫	ceua
甘愿	cevb
荒原	cevb
芒	cewa
蕹	cewa
荒	cewg
蓄	cewt
甘心	cexd
荒谬	ceyw
芳	cf
芳	cfag
蔟	cffd
莓	cfma
蘩	cfmj
芳香	cfpm
菸	cfrd
节	cg
艺	cga
节	cgaa
芎	cgag
节点	cgah
蔗糖	cgbm
蔗	cgch
蒺藜	cgcp
荬	cgdd
苡	cgdr
节制	cgfh
节约	cgjd
勤工助学	cgkd
蒺	cgld
节目	cgma
艺术	cgmd
蘑	cgmo
蘼	cgms
节拍	cgob
艿	cgpa
节日	cgra
勤工俭学	cgrd
艺人	cgrp
节奏	cgsr
节能	cgsu
薄弱环节	cgwc
节省	cgxp
共	ch
廿	cha
艹	chaa
寸步	chaa
散步	chaa
蕻	chab
蔫	chah
世上	chah
共	chba
恭	chbd
荚	chbd
葬送	chbe
世道	chbh
巷道	chbh
莱	chbm
苹	chbo
巷	chbs
恭敬	chcd
茉莉	chcp
散落	chcs
勤劳	chct
黄色	chdb
黄豆	chdh
勤奋	chdt
苛刻	chew
惹事生非	chfa
散失	chfd
共生	chft
寸	chgd
荛	chge
荑	chgr
黄疆	chgt
苇	chha
共事	chhk
世面	chhp
勤恳	chig
萋	chin
芾	chja
恭维	chja
世纪	chjj
黄铜	chjk
黄钟	chjk
黄金	chjp
黄	chkb
颟	chkb
鄞	chke
苛	chkg
觐	chkg
燕	chkh
共同	chkh
散开	chkh
共青团	chkh
勤	chkl
共鸣	chkn
蔌	chkq
堇	chkt
茉	chma
世间	chmr
共存	choa
黄山	choa
散射	choc
恭喜	chod
世袭	chog
散布	choj
共有	chou
共振	chov
黄牛	chow
廾	chpa
黄昏	chpg
共和	chpm
黄瓜	chpp
蕤	chpt
昔	chra
昔日	chra
苤	chrh
世代	chrh
苹果	chrm
鹊	chrn
勤俭	chrr
蕙	chrx
黄海	chsf
黄河	chsh
散漫	chsr
黄土	chth
世界	chtr
菁	chtu
溥	chuc
莆	chud
共需	chuh
散	chuw
世	chwa
贳	chwb
散文	chwd
勤务	chwl
芽	chwp
散发	chwp
苣	chww
葬	chxc
共性	chxf
薤	chxh
世家	chxh
勤快	chxw
共计	chyo
燕子	chzw
萧	ci
萧	ciab
艾	cian
荨	cica
茛	cign
甘肃省	cixp
药	cj
芹	cjaa
芑	cjag
萜	cjak
荮	cjca
蕴藏	cjcv
药	cjdd
药房	cjdo
药方	cjfd
荭	cjga
莼	cjhg
药铺	cjjh
药品	cjkk
药材	cjmh
药物	cjnd
萸	cjra
蕴	cjrm
黄金时代	cjrr
药液	cjse
药水	cjsg
药厂	cjvh
药剂	cjwp
药性	cjxf
芟	cjya
英	ck
蒉	ckab
英寸	ckch
荆	ckda
英	ckda
茵	ckdh
荆州	ckdp
蒽	ckdx
葺	ckea
蕺	ckeg
茼	ckhk
英镑	ckje
苘	ckka
莒	ckka
颧	ckkb
萼	ckkg
茴	ckkh
鹳	ckkn
莴	ckkr
英国	ckkw
英姿	cklq
英尺	ckon
英雄	ckos
苋	ckpg
菌	ckph
芮	ckra
英俊	ckrs
英里	ckrt
英明	ckru
苴	cksa
苦口婆心	cksx
苒	ckta
英文	ckwd
英勇	ckwd
菌丝	ckww
英语	ckyh
苏	cl
蒋	clac
苏	clba
菩萨	clce
苏州	cldp
苏联	cleb
共产主义	cled
薪	clhj
菩	clka
茄	clka
荔	clll
荔枝	clmo
莘	cloa
苏丹	clpg
茨	clqa
薏	clrx
薪水	clsg
共产党员	clxk
共产党	clxt
苏醒	clyr
苯	cm
蔺	cmaa
苜	cmah
基本上	cmah
菘	cmbs
苯	cmha
菥	cmja
葙	cmma
基本原则	cmvb
茹	cn
茑	cnah
茱	cnba
苯鸟先飞	cnfg
茹	cnka
菇	cnok
薅	cnvc
若	co
苦战	coah
苦笑	coap
茬	coat
荐	coaz
蔷	cobh
蔚蓝	coca
葫芦	cocd
荸荠	cocw
苦干	coea
若干	coea
茏	cogd
苦痛	cogl
藏龙卧虎	coha
薹	coht
苦练	cojh
苦	coka
若	coka
茬口	coka
薜	coko
葫	coku
惹	cokx
苦闷	comx
荩	cond
蒜	cooa
蔚	cooc
菝	cood
若有所思	copt
若是	corh
荸	cotz
基础理论	cowy
苦心	coxd
苦恼	coxe
芰	coya
苦难	coya
茇	coyd
董	cp
蕃	cpbt
荞	cpda
藐	cpde
艽	cpga
芄	cpgd
茚	cpge
茆	cpge
芪	cpgg
蓖麻	cpgm
薰	cphh
董事	cphk
董	cpht
萎缩	cpjx
蓖	cpkb
共和国	cpkw
莉	cpmd
藜	cpmd
萎	cpmn
莠	cpmp
芊	cpoa
莪	cpod
莛	cpoz
荇	cprg
蘅	cprg
蓰	cprr
薇	cprw
蘖	cpwm
芨	cpwn
薛	cpwo
孽	cpwz
获	cq
芡	cqan
莽	cqca
获取	cqey
荻	cqha
获奖	cqla
莸	cqod
莽撞	cqol
获得	cqpr
获	cqqa
获胜	cquf
花	cr
莫非	cras
莜	craw
草料	crbm
花粉	crbm
苍白	crbp
花白	crbp
荷兰	crbs
苻	crca
莳	crca
萌芽	crch
草药	crcj
荷花	crcr
花草	crcr
花茶	crcr
苍茫	crcs
花期	crcs
莫	crda
花色	crdb
暮色	crdb
慕	crdd
苓	crdd
莫大	crdh
幕	crdj
募	crdl
蓦	crdm
摹	crdo
暮	crdr
草包	crds
墓	crdt
葛	crdw
芩	crdw
欺人之谈	crdy
花市	crej
荟	cres
草率	crew
荼	crex
蕞	crey
花生	crft
苍	crgg
草皮	crgp
花费	crgp
花序	crgw
荷	crhg
莶	crhh
莫不	crhr
蔹	crhw
茶	crhx
花朵	crjm
草帽	crjr
花纹	crjw
花圈	crkb
花园	crke
葆	crkm
茶叶	crko
荷叶	crko
草图	crkw
莅	crla
蓓	crlk
花瓣	crlo
花椒	crma
苍松	crmb
草棚	crmu
茶树	crmy
花样	crmy
草	croa
花卉	croc
草拟	crog
茌	croh
茶壶	croh
花布	croj
芥	crpa
蔓延	crpa
荏	crph
草稿	crpm
花	crqa
茯	crqa
苁	crra
菖	crra
草丛	crrr
茶水	crsg
蔓	crsy
草地	crtg
荷塘	crtg
草坪	crth
苍老	crtp
荷载	crtv
萌	crua
草鱼	crup
草原	crvb
苍蝇	crvk
荃	crwa
苍劲	crwd
草书	crwg
苍翠	crwl
萌发	crwp
草案	crxn
其	cs
藕	csad
葜	csad
萝卜	csad
基点	csah
基督	csah
藉	csar
其	csba
戡	csbg
斯	csbj
綦	csbj
勘	csbl
斟	csbo
欺	csbq
基	csbt
期	csbu
甚	csbw
菠菜	csca
蒙混过关	cscb
菠萝	cscs
茫茫	cscs
蒗	csdn
期刊	csea
基于	cseg
期望	cseg
其二	cseh
期限	csei
茫	csew
落选	csfa
茳	csga
范	csgg
薄弱	csgl
荡	csgp
菠	csgy
薄	cshc
蒲	cshd
菏	cshg
其一	cshh
蕖	cshm
萍	csho
甚至	cshs
基建	csie
基金	csjp
苔	cska
其中	cska
基因	cskd
范围	cskh
藻	cskm
落叶	csko
菹	csks
基准	csla
其次	cslq
欺骗	csmd
基本	csmh
期间	csmr
其间	csmr
基层	csoe
蔑视	csok
勘探	csot
基础	csow
薄片	cspa
蒎	cspn
落后	cspp
期待	cspr
甚么	csps
藩	cspt
其余	csre
欺侮	csrf
其他	csrg
范例	csrh
落伍	csrh
蓁	csrm
荡漾	cssb
勘测	cssb
期满	cssc
落水	cssg
薨	cstb
甍	cstd
基地	cstg
落地	cstg
瞢	cstm
薯	cstr
范畴	csts
薄膜	csuc
蔑	csvd
落成	csvg
欺压	csvt
落	cswk
萝	csxa
其它	csxb
落实	csxd
茫然	csxd
其实	csxd
落空	csxg
莎	csxp
斟酌	csyd
勘误	csyk
带	ct
苗	ct
营业	ctaa
芏	ctah
蒙受	ctat
营养	ctbs
菱	ctbw
劳苦	ctco
荣获	ctcq
荣誉	ctdb
营房	ctdo
蒙	cten
劳动	ctes
营造	ctfa
劳工	ctgh
茕	ctgo
荧	ctha
萤火	cthd
萦	ctja
蓥	ctja
营销	ctjx
营	ctkk
菱形	ctkp
劳	ctla
劳力	ctlg
劳驾	ctlk
荣	ctma
劳模	ctmc
著述	ctmd
荦	ctna
莺	ctna
鹋	ctna
蒙古	ctok
著称	ctpm
著	ctpr
蓍	ctpr
劳役	ctpr
莰	ctqa
蒙昧	ctre
著作	ctrf
劳保	ctrk
荥	ctsa
茔	ctta
荣幸	cttb
葑	cttc
劳累	cttj
著者	cttp
荤	ctva
萤	ctva
营长	ctvp
莹	ctwd
劳务	ctwl
葸	ctxa
荧光	ctxh
著名	ctxk
世界观	ctyk
藤	cu
藿	cuaa
藤	cubd
蓟	cuda
菔	cuey
薷	cuha
蕾	cuta
蒯	cuud
藓	cuya
藏	cv
茧	cvad
苌	cvan
蒇	cvbd
蕨	cvbq
莲花	cvcr
蓐	cvec
藏族	cvff
茂	cvgd
苊	cvgg
葳	cvhd
苈	cvla
藏身	cvop
茂盛	cvvg
藏	cvwd
藏书	cvwg
茂密	cvxd
莲	cvza
茎	cw
蔬	cwag
茁	cwao
蔬菜	cwca
葵花	cwcr
茅草	cwcr
蓣	cwdb
葵	cwdd
茎	cwdg
茅	cwdp
菡	cwga
苠	cwhg
葭	cwhy
茁壮	cwla
蓼	cwlp
蓬松	cwmb
茅屋	cwoh
蒸馏	cwop
蓬勃	cwot
荠	cwpa
蒸	cwsh
蒸汽	cwsq
蓬	cwsz
芗	cwwp
蒸发	cwwp
芯	cx
芯	cxad
茜	cxah
莫名其妙	cxcn
蔡	cxdo
莞	cxee
蔻	cxey
节外生枝	cxfm
苑	cxgg
苎	cxha
萱	cxhh
茗	cxka
蔽	cxkw
菪	cxoa
芯片	cxpa
蓿	cxrb
蓉	cxrk
蕈	cxro
菅	cxwh
菀	cxxg
蕊	cxxx
蘸	cy
蘸	cyah
蔼	cyrw
过	cz
过分	czbd
过道	czbh
过节	czcg
过期	czcs
过头	czdd
过	czdn
过于	czeg
过夜	czer
过失	czfd
过年	czfh
过敏	czfm
芤	czga
过度	czgc
过来	czhb
过火	czhd
过错	czjc
过路	czka
过问	czmk
过硬	czoh
过程	czpm
菰	czpn
过剩	czpo
过后	czpp
过时	czrc
过量	czrh
过人	czrp
过滤	czsa
过渡	czsg
过去	czts
过冬	czwd
荪	czxa
过少	czxp
的	d
良师益友	dabo
兴师动众	daer
刂	dag
大步流星	dasr
学	db
举止	dbaa
学业	dbaa
色彩	dbam
负数	dbbm
黉	dbcb
学艺	dbcg
举世	dbch
负荷	dbcr
学期	dbcs
争分夺秒	dbdp
兴奋	dbdt
大公无私	dbep
举动	dbes
触类旁通	dbew
学院	dbex
学年	dbfh
学制	dbfh
学生	dbft
学习	dbgl
学费	dbgp
学府	dbgr
兴	dbhb
举	dbho
兴致	dbhs
负责	dbht
色素	dbht
誉	dbhy
兴建	dbie
学风	dbji
学员	dbkb
举办	dblb
兴办	dblb
学术	dbmd
学校	dbme
学问	dbmk
负极	dbmp
学好	dbnz
学士	dboh
举手	dbop
负担	dbor
学社	dbot
负片	dbpa
负重	dbph
学科	dbpm
举行	dbpr
觉得	dbpr
学徒	dbpr
兴修	dbra
学时	dbrc
学会	dbre
负伤	dbrf
负电	dbrg
负债	dbrh
举例	dbrh
学位	dbrl
鹩	dbrn
兴旺	dbrw
学派	dbsp
色泽	dbsy
觉	dbtg
喾	dbtk
学者	dbtp
泶	dbts
鲎	dbtu
负载	dbtv
学	dbtz
兴盛	dbvg
学历	dbvl
负	dbwd
色	dbwg
觉悟	dbxh
色光	dbxh
学名	dbxk
学堂	dbxt
觉察	dbxx
学说	dbyb
学识	dbyk
色调	dbyp
觉醒	dbyr
兴趣	dbze
兴起	dbzj
夺	dc
夺取	dcey
为期不远	dche
夺回	dckk
夺目	dcma
举世闻名	dcmx
夺	dcnd
夺得	dcpr
丶	dd
太监	ddaa
头颅	ddah
忍受	ddat
头等	ddat
太爷	ddbi
头	ddd
太太	dddd
斗争	dddi
太阳	dder
大学生	ddft
勺	ddg
态度	ddgc
头痛	ddgl
太平	ddhb
头顶	ddhg
忍耐	ddhp
灸	ddhw
头巾	ddja
头绪	ddjt
头号	ddkh
头骨	ddkw
头部	ddlk
头目	ddma
太极	ddmp
太	ddn
斗	ddo
斗志	ddoh
刃	ddp
太后	ddpp
头衔	ddpr
太湖	ddso
头脑	ddue
太原	ddvb
头发	ddwp
太守	ddxc
忍心	ddxd
太空	ddxg
态	ddxn
忍	ddxp
勺子	ddzw
太子	ddzw
夸	de
兴高采烈	deah
夸大	dedh
刳	degd
夸	degn
瓠	degn
匏	degs
夸张	degv
夸口	deka
夸奖	dela
大规模	demc
耷	denh
耷拉	deol
太阳能	desu
夸耀	dexh
防	df
争先恐后	dfgp
大失所望	dfpe
解放军报	dfto
解放军	dftv
必	dg
必	dgdd
刀刃	dgdd
永久	dgdn
永远	dgee
刀锋	dgjw
刀口	dgka
永别	dgkl
刀具	dgks
必将	dgla
永磁	dgob
刀	dgp
刀片	dgpa
必须	dgpp
豇	dgth
必胜	dguf
必需	dguh
永	dgwn
昶	dgwr
必备	dgwt
必然	dgxd
必定	dgxh
永恒	dgxh
必要	dgxn
刀子	dgzw
大	dh
大步	dhaa
大业	dhaa
大卡	dhah
大叔	dhah
套筒	dhak
大师	dhap
套	dhas
豆	dhaw
大半	dhbe
大道	dhbh
大爷	dhbi
大米	dhbm
豆粒	dhbm
奇数	dhbm
大雁	dhbr
大败	dhbw
大举	dhdb
大兴	dhdb
大学	dhdb
大头	dhdd
大大	dhdh
大豆	dhdh
大象	dhdk
大干	dhea
大陆	dhee
大于	dheg
奇迹	dhep
大队	dher
大夫	dher
大专	dhew
大院	dhex
大选	dhfa
大方	dhfd
大年	dhfh
大庆	dhgd
大麻	dhgm
豆腐	dhgr
大臣	dhha
大肆	dhha
大火	dhhd
大炮	dhhd
大哥	dhhk
大事	dhhk
大致	dhhs
大麦	dhht
大衣	dhid
奁	dhiw
大凡	dhjd
大约	dhjd
大风	dhji
大纲	dhjk
大路	dhka
剞	dhkd
大型	dhkd
奇	dhkg
大同	dhkh
欹	dhkq
匐	dhkt
大将	dhla
豆浆	dhla
大力	dhlg
大部	dhlk
大意	dhlr
大楼	dhmb
大门	dhmd
大概	dhmi
大权	dhmy
大娘	dhnd
大嫂	dhnj
大姐	dhnk
大妈	dhnm
奇特	dhnt
大婶	dhnx
奇妙	dhnx
大好	dhnz
大批	dhob
豆饼	dhob
大鼓	dhod
大局	dhog
兴致勃勃	dhoo
大抵	dhop
大势	dhop
大有	dhou
豆科	dhpm
套种	dhpm
大	dhpn
大敌	dhpo
大街	dhpr
大气	dhqp
大修	dhra
大伯	dhrb
大会	dhre
大作	dhrf
大量	dhrh
大使	dhrh
大体	dhrm
大人	dhrp
大众	dhrr
奇异	dhsc
大汗	dhse
大海	dhsf
大江	dhsg
大水	dhsg
大河	dhsh
大洋	dhsy
太平洋	dhsy
大地	dhtg
大写	dhth
大军	dhtv
大块	dhtw
匍	dhud
举不胜举	dhud
大脑	dhue
大雨	dhuh
大腿	dhui
大雪	dhui
大胆	dhur
大车	dhvh
大厅	dhvh
奋不顾身	dhvo
大连	dhvz
大理	dhwr
大小	dhxg
大家	dhxh
大宗	dhxo
大多	dhxx
奇怪	dhxy
奇观	dhyk
豆子	dhzw
义	di
雏	diaw
煞白	dibp
鬯	didb
争夺	didc
急于	dieg
邹	diew
争取	diey
郎	dige
良	dign
朗	digu
争	digw
皱	digy
急救	dihg
急速	dihk
皱纹	dijw
急躁	dika
争鸣	dikn
雏形	dikp
争吵	dikx
争辩	dilo
争端	dilo
急骤	dime
义	din
匈奴	diny
良好	dinz
急剧	dioo
争执	diop
良种	dipm
急切	diqd
争气	diqp
急电	dirg
急促	dirk
急件	dirn
急流	dise
良田	dita
急需	diuh
匈	diwa
煞	diwh
刍	diwh
义务	diwl
良心	dixd
急忙	dixe
急性	dixf
义愤	dixo
急	dixw
争议	diyd
朗读	diyo
争论	diyr
朗诵	diyw
象	dk
召集	dkam
奂	dkdw
象限	dkei
邵	dkep
免除	dker
句	dkgh
勉强	dkgk
免疫	dkgl
免费	dkgp
召唤	dkkd
召开	dkkh
劬	dklg
象棋	dkmc
象样	dkmy
鸲	dkng
象山	dkoa
兔	dkpd
免	dkpg
召	dkph
勉	dkpl
免税	dkpm
象	dkpn
免得	dkpr
象征	dkpr
逸	dkpz
句法	dkst
勉励	dkvh
奇形怪状	dkxl
大同小异	dkxs
够	dkxx
象话	dkyp
迢	dkzp
句子	dkzw
兔子	dkzw
为止	dlaa
为此	dlab
大部分	dlbd
为首	dlbh
为数	dlbm
为期	dlcs
为	dld
为主	dlet
匀	dlgt
匀速	dlhk
夯	dlnp
匀称	dlpm
为何	dlrh
为人	dlrp
为了	dlwg
为名	dlxk
为难	dlya
为着	dlym
久	dn
久仰	dnrp
久	dnw
房	do
雇	doa
扉	doas
奔	docn
启蒙	doct
肩负	dodb
户头	dodd
肩头	dodd
戽	dodo
启动	does
扇动	does
房	dof
扇	dogl
扁平	dohb
大有可为	dohd
房东	dohw
启	dok
奔跑	doka
户口	doka
扈	dokb
扁	dokc
扃	dokk
翩	dokl
遍	dokz
房产	dolp
奔驰	domg
房间	domr
奈	dond
房屋	dooh
启示	dooh
遍布	dooj
扁担	door
户	dop
房租	dopm
遍及	dopw
戾	doq
大有作为	dord
雇佣	doru
奔流	dose
奔波	dosg
遍地	dotg
肩	dou
奔腾	doub
肩膀	doue
綮	dowj
肇	dowo
启发	dowp
豉	doyt
奔赴	doza
奔走	dozh
房子	dozw
扇子	dozw
州	dp
夼	dpaa
州	dpda
匆匆	dpdp
兴利除弊	dpex
勹	dpg
房租费	dpgp
忽而	dphp
忽视	dpok
匆	dppd
刎	dppd
勿	dppg
忽	dppx
匆促	dprk
忽略	dptw
忽然	dpxd
匆忙	dpxe
郇	dreg
鹌鹑	drek
旬	drgh
奄	drgn
鹌	drgn
龟	drgw
大显身手	droo
大使馆	drox
遍体鳞伤	drur
兴旺发达	drwd
包庇	dsbb
包头	dsdd
刨	dsdg
包干	dsea
包裹	dser
勾引	dsga
勾	dsgd
包	dsgg
包袱	dsir
勾结	dsjo
包围	dskh
包装	dsla
包办	dslb
包扎	dsog
包括	dsop
包含	dsrd
大洋洲	dssd
包车	dsvh
勾当	dsxi
奋	dt
奋战	dtah
奋斗	dtdd
牵制	dtfh
牵引	dtga
甸	dtgh
牵	dtnd
奋	dtnh
牵扯	dtoa
牵挂	dtot
奢	dtpr
牵伸	dtrr
奢侈	dtrx
牵涉	dtsa
奎	dttn
牵连	dtvz
奋勇	dtwd
奋发	dtwp
奋起	dtzj
解	du
觫	duab
觖	duad
觥	duae
解	duan
觚	duan
斛	duao
觯	duao
觞	duap
解答	duar
触	duav
蟹	duav
角	duaw
邂	duaz
解散	duch
角落	ducs
触觉	dudb
触角	dudu
解除	duer
触动	dues
解放	dufw
角度	dugc
解救	duhg
解开	dukh
解围	dukh
解冻	dulh
解剖	dulk
解决	dulw
解释	dupb
触及	dupw
触犯	duqg
触电	durg
解体	durm
解脱	duub
触发	duwp
解说	duyb
解调	duyp
詹	dvby
危急	dvdi
太原市	dvej
危险	dver
危亡	dvew
危	dvgg
危机	dvmj
危及	dvpw
危害	dvxs
之	dw
之上	dwah
之前	dwbh
之下	dwha
之一	dwhh
奋发图强	dwkg
之内	dwkr
之间	dwmr
之	dwn
之后	dwpp
之外	dwxa
奋勇当先	dwxf
大多数	dxbm
豌豆	dxdh
大西洋	dxsy
必然性	dxxf
必要性	dxxf
豌	dxxg
訇	dygh
奇谈怪论	dyxy
达	dz
达	dzdn
逗	dzhn
达到	dzhs
逗号	dzkh
急起直追	dzop
逗留	dzpg
达成	dzvg
而	e
变	ea
变频	eaaa
弯	eaag
銮	eaaj
骘	eaam
栾	eaam
娈	eaan
鸾	eaan
峦	eaao
挛	eaao
陟	eaap
耻笑	eaap
脔	eaar
恋爱	eaat
蛮	eaav
恋	eaax
变	eaay
孪	eaaz
未	eabh
未遂	eabh
未曾	eabk
干粮	eabm
嫠	eabn
变色	eadb
变态	eadd
未必	eadg
卞	eadh
刊	eadh
未免	eadk
变为	eadl
除此之外	eadx
邗	eaeh
高等院校	eaem
变动	eaes
未知	eafd
专业知识	eafy
武	eagd
变革	eagh
鹉	eagn
干	eah
顸	eahb
未来	eahb
阽	eahk
变速	eahk
干事	eahk
干燥	eahk
未可	eahk
变更	eahr
干线	eaje
未经	eajw
弯路	eaka
弯曲	eakc
武器	eakk
干吗	eakm
变形	eakp
武装	eala
干净	eald
武力	ealg
干部	ealk
商业部	ealk
蛮横	eamc
武术	eamd
干杯	eamh
变相	eamm
干枯	eamo
刊物	eand
变换	eaod
变故	eaok
干扰	eaoo
变种	eapm
变迁	eapo
变质	eapp
干旱	eare
变量	earh
专业人员	eark
变化	earq
专业化	earq
武昌	earr
干涉	easa
变异	easc
干涸	eask
干活	easp
变法	east
未能	easu
武汉	easy
耻	eath
刊载	eatv
干脆	eaud
耻辱	eave
变成	eavg
干劲	eawd
干预	eawd
刊登	eawd
未尝	eaxt
专业对口	eayk
六	eb
商业	ebaa
交点	ebah
交战	ebah
商船	ebaj
交售	ebak
隧道	ebbh
效益	ebbh
聪颖	ebbp
陛	ebbt
联营	ebct
效劳	ebct
联大	ebdh
胖	ebea
联防	ebef
交际	ebeo
联	eber
交替	eber
效率	ebew
商店	ebga
效应	ebgd
陛下	ebha
六	ebhd
郊区	ebhi
交融	ebhk
隘	ebhm
交还	ebhr
隧	ebhz
郊	ebie
交	ebih
效	ebiw
交错	ebjc
交纳	ebjk
交织	ebjk
联结	ebjo
联络	ebjw
联锁	ebjx
旁听	ebkj
商	ebkk
商品	ebkk
帝国	ebkw
聪	ebkx
效力	eblg
交加	eblk
旁边	eblz
联想	ebmm
商标	ebmo
商榷	ebmt
交换	ebod
交接	ebol
联接	ebol
联系	ebpj
陴	ebpo
交往	ebpr
隗	ebps
交付	ebrc
交易	ebrd
商会	ebre
效仿	ebrf
交代	ebrh
联合	ebrh
商量	ebrh
效果	ebrm
聚精会神	ebro
旁人	ebrp
商人	ebrp
交货	ebrq
联盟	ebru
聪明	ebru
聪慧	ebsa
交涉	ebsa
兖	ebse
交流	ebse
衮	ebsi
联邦	ebsp
效法	ebst
效能	ebsu
旁	ebtf
商场	ebtg
帝	ebtj
啻	ebtk
交界	ebtr
联军	ebtv
效用	ebua
六月	ebup
隍	ebwa
交出	ebwa
交通	ebwd
帝王	ebwh
商务	ebwl
郊外	ebxa
交情	ebxh
商定	ebxh
联名	ebxk
商讨	ebyc
交叉	ebyd
商议	ebyd
交差	ebyg
交谈	ebyh
商谈	ebyh
交配	ebyj
旁观	ebyk
联欢	ebyq
胖子	ebzw
旁若无人	ecer
隐	ed
陷落	edcs
隐藏	edcv
隐蔽	edcx
陷于	edeg
陶	edfa
亠	edh
取之不尽	edho
隐	edix
陷	edja
隐约	edjd
陶器	edkk
隐患	edkk
陶瓷	edlq
隐瞒	edmc
陷入	edpn
陷害	edxs
陶醉	edye
元	ee
远航	eeae
元首	eebh
毫无疑问	eebm
远大	eedh
阮	eeea
远远	eeee
远方	eefd
元年	eefh
二进制	eefh
顽强	eegk
顽皮	eegp
顽	eehb
元	eehg
元素	eeht
远东	eehw
隐隐约约	eejj
陆续	eejo
远近	eejz
运动员	eekb
鼋	eekg
顽固	eeko
远见	eekp
陆	eeoa
远在	eeoa
顽抗	eeoe
远古	eeok
元朝	eeor
阱	eepa
远行	eepr
远景	eere
元旦	eerh
元件	eern
元帅	eesp
远洋	eesy
耶	eeta
陆地	eetg
陆军	eetv
元月	eeup
陔	eewr
元宵	eexx
陬	eeya
远	eezh
防止	efaa
阼	efae
防	efag
防范	efcs
防卫	efga
防火	efhd
防毒	efht
防线	efje
防风	efji
防护	efod
防御	efpr
防水	efsg
防汛	efsg
防潮	efso
防治	efss
防务	efwl
防备	efwt
防守	efxc
于	eg
卩	ega
阝	ega
亏	egh
于	egh
亍	egh
夜以继日	egjr
迂回	egkk
盂	egmh
亏损	egok
戋	egpd
盏	egpm
亏待	egpr
陂	egpy
于今	egrd
于是	egrh
望	eguw
迂	egzh
二	eh
耳	ehaa
进一步	ehaa
陈旧	ehar
二等	ehat
无可非议	ehay
陌	ehba
陕	ehbd
隔断	ehbm
二黄	ehch
无可奈何	ehdr
阢	ehea
二元	ehee
隔离	ehei
陈迹	ehep
陌生	ehft
望而生畏	ehft
陈腐	ehgr
耵	ehgt
二	ehh
陈列	ehhx
隔绝	ehjd
耳朵	ehjm
隔	ehka
阿	ehkg
隔开	ehkh
陋	ehkw
耳目	ehma
陈述	ehmd
隔阂	ehme
耳机	ehmj
阿姨	ehnh
隔壁	ehok
隔热	ehop
取而代之	ehrd
阿曼	ehrs
无可奉告	ehsf
耿	ehtn
二者	ehtp
二月	ehup
陈	ehwx
耳光	ehxh
陕西	ehxh
刻不容缓	ehxj
耳语	ehyh
陈设	ehyj
离	ei
离散	eich
限期	eics
离解	eidu
限于	eieg
天衣无缝	eiej
离职	eiek
限制	eifh
限度	eigc
限	eign
离开	eikh
离别	eikl
离婚	einp
离休	eirm
离	eiws
离心	eixd
限定	eixh
限额	eixw
离子	eizw
市	ej
市郊	ejeb
无缘无故	ejeo
市	ejha
市政	ejha
颃	ejhb
联绵不断	ejhb
亢	ejhg
市区	ejhi
市面	ejhp
裒	ejih
市镇	ejjo
市内	ejkr
市委	ejpm
无线电	ejrg
市场	ejtg
市长	ejvp
市民	ejwh
市容	ejxr
高	ek
高频	ekaa
就业	ekaa
职业	ekaa
阻止	ekaa
聩	ekab
就此	ekab
衷	ekai
就算	ekam
京师	ekap
高龄	ekar
高等	ekat
享受	ekat
陨	ekba
毫米	ekbm
职	ekbt
衰落	ekcs
高举	ekdb
高兴	ekdb
高大	ekdh
衰变	ekea
高效	ekeb
高于	ekeg
高亢	ekej
高高	ekek
就职	ekek
阻击	ekeo
襄阳	eker
颤动	ekes
高矮	ekfd
高度	ekgc
亮度	ekgc
职工	ekgh
豪强	ekgk
哀痛	ekgl
熟习	ekgl
衰弱	ekgl
高炉	ekhd
哀求	ekhg
衰	ekhi
高速	ekhk
豪迈	ekhp
毫不	ekhr
职责	ekht
高雅	ekhw
衰退	ekig
哀	ekih
熟练	ekjh
高级	ekjp
豪绅	ekjr
就绪	ekjt
就近	ekjz
高贵	ekka
高中	ekka
颤	ekkb
职员	ekkb
襄	ekki
高	ekkk
职别	ekkl
瓤	ekkn
禀	ekko
高呼	ekkp
高见	ekkp
高喊	ekkv
敲	ekky
阻力	eklg
高产	eklp
颤音	eklr
衰减	eklv
高档	ekmx
敲榨	ekmx
职权	ekmy
高山	ekoa
阻拦	ekob
颤抖	ekod
阻抗	ekoe
聘	ekog
高声	ekoh
敲打	ekoh
陨石	ekoh
阻挠	ekoh
毫克	ekok
京胡	ekok
京剧	ekoo
阻碍	ekor
享有	ekou
高峰	ekow
阻挡	ekox
熟悉	ekpb
毫升	ekpc
哀愁	ekpm
高利	ekpm
职称	ekpm
哀乐	ekpw
享乐	ekpw
哀伤	ekrf
高傲	ekrh
就是	ekrh
职位	ekrl
阻值	ekro
高昂	ekrp
高低	ekrp
就任	ekrp
聘任	ekrp
豪华	ekrq
高价	ekrr
高耸	ekrr
高明	ekru
阻	eksa
高粱	eksd
高涨	eksg
高潮	ekso
高温	eksr
高深	ekst
高能	eksu
职能	eksu
亭	ektg
高地	ektg
就地	ektg
亮	ektj
毫	ektm
豪	ektn
衰老	ektp
亳	ektq
聃	ektt
膏	ektu
京城	ektv
哀思	ektx
享用	ekua
高原	ekvb
无足轻重	ekvp
高压	ekvt
亨	ekwg
职务	ekwl
哀悼	ekxa
就	ekxd
衷心	ekxd
高空	ekxg
京	ekxh
高寒	ekxh
阻塞	ekxh
高尚	ekxk
鹫	ekxn
毫安	ekxn
就要	ekxn
聘请	ekyh
熟识	ekyk
孰	ekzd
郭	ekze
熟	ekzh
享	ekzh
鹑	ekzn
塾	ekzt
敦	ekzw
亭子	ekzw
憝	ekzx
陪	el
无产阶级	elej
陪衬	elic
陪	elka
陪同	elkh
烹饪	elop
障碍	elor
陪伴	elrb
障	elro
烹	elwh
陪审	elxr
烹调	elyp
高档商品	emek
高瞻远嘱	emek
随机应变	emge
耳目一新	emhl
动物园	enke
随	eo
际	eoad
击毙	eobb
击败	eobw
堕落	eocs
击落	eocs
无拘无束	eoeh
陇	eogd
隳	eogd
隋	eogu
击	eoha
击退	eoig
随即	eoig
击毁	eojg
击中	eoka
随同	eokh
随意	eolr
随机	eomj
随身	eoop
随手	eoop
亵	eopi
随后	eopp
随行	eopr
随时	eorc
随便	eorh
随从	eorr
击溃	eosk
随地	eotg
堕	eout
随	eouz
随处	eowa
击球	eowh
击穿	eoxh
云南省	eoxp
随着	eoym
进	ep
进步	epaa
井	epah
亓	epah
井筒	epak
无非	epas
进	epaz
无比	epbb
无关	epbe
无疑	epbf
无益	epbh
无数	epbm
无期	epcs
无色	epdb
无耻	epea
无效	epeb
无限	epei
无阻	epek
无聊	epep
聊天	eper
进取	epey
无知	epfd
儿	epg
亦	epgb
弈	epgc
进度	epgc
奕	epgd
聊	epge
无	epgh
进攻	epgw
迹	epgz
进来	ephb
无微不至	ephh
儿歌	ephk
无可	ephk
无赖	ephk
进而	ephp
无不	ephr
进退	epig
亦即	epig
联系群众	epir
无线	epje
进口	epka
井口	epka
无味	epke
无形	epkp
无力	eplg
无端	eplo
儿童	eplr
无意	eplr
无边	eplz
进驻	epme
无机	epmj
无权	epmy
儿女	epnw
阡	epoa
进展	epoc
陲	epoh
无声	epoh
聒	epok
无辜	epok
无故	epok
无视	epok
忘乎所以	eppg
进程	eppm
无私	eppm
进入	eppn
无敌	eppo
无须	eppp
进行	eppr
阪	eppy
进犯	epqg
进修	epra
无所作为	eprd
无人	eprp
联系人	eprp
进化	eprq
无从	eprr
无偿	eprx
无罪	epsa
无异	epsc
进水	epsg
无法	epst
专利法	epst
无能	epsu
进去	epts
进军	eptv
无用	epua
无需	epuh
进出	epwa
进发	epwp
无理	epwr
无心	epxd
联系实际	epxe
规律性	epxf
无情	epxh
无名	epxk
无穷	epxl
无误	epyk
无论	epyr
儿子	epzw
天气预报	eqwo
天	er
阳	erah
天上	erah
队	eran
除非	eras
规则	erbd
天赋	erbe
吞并	erbk
除数	erbm
天数	erbm
褒贬	erbp
天赐	erbr
附	erca
附带	erca
除草	ercr
夜幕	ercr
规范	ercs
坠落	ercs
天色	erdb
夜色	erdb
聆	erdd
蚕豆	erdh
天亮	erek
天井	erep
替	erer
天天	erer
天险	erer
随时随地	eret
辇	erev
除	erex
规矩	erfd
天生	erft
规划	ergd
天下	erha
险恶	erha
天平	erhb
聪明才智	erhf
天才	erhg
险	erhh
夫妻	erhi
夫	erhn
天	erhn
坠毁	erjg
阶级	erjp
附近	erjz
吞噬	erka
队员	erkb
隅	erkd
规	erkg
吞	erkh
褒	erki
附图	erkw
天国	erkw
联合国	erkw
附加	erlk
规章	erlr
天边	erlz
阶梯	ermb
规模	ermc
夜校	erme
裹	ermi
阳极	ermp
夜间	ermr
规格	ermw
夫妇	erni
除掉	eroa
天山	eroa
替换	erod
阶层	eroe
规避	erok
天真	erok
附属	erop
吞食	erop
险峻	eros
阶	erpa
阶段	erpa
附和	erpm
规程	erpm
天敌	erpo
规律	erpr
天气	erqp
天时	errc
夜晚	errd
队伍	errh
替代	errh
天命	errh
天体	errm
附件	errn
卒	erro
天仙	erro
夫人	errp
夜里	errt
天明	erru
附注	erse
天水	ersg
天津	ersi
吞没	ersj
阳台	ersk
除法	erst
天涯	ersv
坠	erta
陧	erta
天地	ertg
蚕	ervh
阳历	ervl
队长	ervp
天文	erwd
夜班	erwd
附录	erwe
除了	erwg
隰	erwh
天理	erwr
蚕丝	erww
除外	erxa
忝	erxd
天然	erxd
天性	erxf
阳性	erxf
天空	erxg
夜空	erxg
规定	erxh
阳光	erxh
除名	erxk
夜	erxn
险要	erxn
除夕	erxp
除尘	erxt
天堂	erxt
附着	erym
天子	erzw
动	es
云彩	esam
运算	esam
运筹	esas
充分	esbd
运送	esbe
充数	esbm
魂	esbs
充公	esbs
弃	esch
动荡	escs
动态	esdd
育雏	esdi
无能为力	esdl
充	eseh
阳奉阴违	eseh
天津市	esej
武汉市	esej
云云	eses
运动	eses
动弹	esgb
动工	esgh
运费	esgp
云	eshd
动静	esht
充足	eska
动员	eskb
动听	eskj
动力	eslg
动	eslh
动产	eslp
动机	esmj
云杉	esmp
云母	esmw
动物	esnd
动摇	esoa
育苗	esoc
云南	esok
动身	esop
动手	esop
动向	espk
充血	espm
育秧	espm
育种	espm
运行	espr
运气	esqp
动作	esrf
充电	esrg
动量	esrh
动人	esrp
充满	essc
充沛	essh
运河	essh
动能	essu
充填	esto
动用	esua
运用	esua
育肥	esub
动脉	esud
育	esuh
云雾	esuw
运转	esve
运输	esvr
充实	esxd
动心	esxd
充当	esxi
运	eszh
主	et
主管	etax
陵	etbw
主义	etdi
主角	etdu
主干	etea
主动	etes
主席	etgc
主张	etgv
亩	ethh
主	ethh
隈	ethn
主编	etjd
主将	etla
主办	etlb
主力	etlg
主次	etlq
主意	etlr
主根	etmi
主机	etmj
主权	etmy
耽搁	etom
主食	etop
主持	etot
主峰	etow
耽	etpg
主题	etrh
主体	etrm
主人	etrp
主任	etrp
市场信息	etrp
主导	etsc
主流	etse
主轴	etvk
主宰	etxl
主要	etxn
市场调节	etyc
耽误	etyk
主观	etyk
主子	etzw
阴	eu
阴	euah
阴天	euer
阴险	euer
阴阳	euer
阴凉	eule
阴森	eumm
阴极	eump
运用自如	eupn
阴影	eure
阴暗	eurl
阴沉	eust
阴雨	euuh
阴历	euvl
阴谋	euyc
专用设备	euyw
阵	ev
阵	evaa
阵营	evct
取长补短	evif
阵线	evje
阵势	evop
阵地	evtg
阵雨	evuh
阵容	evxr
率	ew
降临	ewaa
专业	ewaa
刻苦	ewco
降落	ewcs
专著	ewct
玄学	ewdb
陉	ewdg
专	ewdh
袤	ewdi
专刊	ewea
交通规则	eweb
邙	eweh
降职	ewek
专职	ewek
无理取闹	ewem
隆隆	ewew
专制	ewfh
刻度	ewgc
刻划	ewgd
交通工具	ewgk
亡	ewh
降	ewha
专政	ewha
专区	ewhi
隆	ewht
刻画	ewht
专线	ewje
赢	ewkd
嬴	ewkd
蠃	ewkd
羸	ewkd
妄图	ewkw
干劲冲天	ewle
交通部	ewlk
盲目	ewma
专栏	ewmb
专门	ewmd
盲	ewmh
妄想	ewmm
妄	ewnh
畜牧	ewnw
忘掉	ewoa
专卖	ewog
颏	ewpb
刻	ewpd
隆重	ewph
劾	ewpl
赢利	ewpm
专程	ewpm
专科	ewpm
专利	ewpm
忘我	ewpo
亥	ewpr
赢得	ewpr
率领	ewrd
专电	ewrg
专题	ewrh
降低	ewrp
专人	ewrp
降价	ewrr
降水	ewsg
玄	ewsh
率	ewso
降温	ewsr
畜	ewst
忘却	ewts
专用	ewua
肓	ewuh
降雨	ewuh
专长	ewvp
雍	ewwa
氓	ewwg
饔	ewwo
壅	ewwt
专心	ewxd
忘	ewxh
忘怀	ewxh
专家	ewxh
忘记	ewyj
隆起	ewzj
院	ex
陀	exba
无名英雄	exco
院落	excs
院	exee
无穷无尽	exeo
聍	exhg
天安门	exmd
院校	exme
主要人员	exrk
天灾人祸	exro
隙	exrx
主要原因	exvk
院长	exvp
陕西省	exxp
院子	exzw
取	ey
聚集	eyam
取笑	eyap
聚变	eyea
取下	eyha
取缔	eyje
取决	eylw
取材	eymh
取样	eymy
高谈阔论	eymy
无论如何	eynr
娶	eynt
聚居	eyoo
鄹	eype
聚	eypn
取得	eypr
取暖	eyra
聚会	eyre
取舍	eyre
聚合	eyrh
取代	eyrh
取消	eysx
取	eytn
取胜	eyuf
取出	eywa
颞	eyyb
聂	eyyh
阴谋诡计	eyyy
陡	ezan
陡峭	ezox
陡然	ezxd
发	f
先	fa
造船	faaj
选集	faam
先辈	faas
先前	fabh
赞颂	fabs
赞美	fabw
选举	fadb
赞誉	fadb
告急	fadi
乍	faeh
造就	faek
先进	faep
先天	faer
选育	faes
怎	faex
选取	faey
迮	faez
先生	faft
选项	fagh
赞	fahb
选煤	fahc
先	fahe
郜	fahe
罅	fahg
告	fahk
鹄	fahn
靠	fahs
先烈	fahx
选	fahz
造	fahz
造纸	fajp
先锋	fajw
靠近	fajz
先遣	faka
造型	fakd
赞同	fakh
告别	fakl
赞助	faks
赞叹	faky
告状	fala
先决	falw
靠边	falz
先驱	famh
造林	famm
怎样	famy
靠山	faoa
选矿	faog
赞扬	faog
告示	faoh
造福	faoh
靠拢	faoo
选拔	faoo
先手	faop
选手	faop
选择	faoy
选种	fapm
告辞	fapo
先后	fapp
造反	fapp
先行	fapr
怎么	faps
先令	fard
先例	farh
先是	farh
造价	farr
选派	fasp
选用	faua
赞成	favg
造成	favg
选民	fawh
告密	faxd
选定	faxh
赞赏	faxt
造谣	faya
造诣	fayb
赞许	fayf
告诫	fayh
告诉	fayj
选配	fayj
舞	fc
舞	fcaa
罐头	fcdd
罐	fcka
舞蹈	fcka
繁荣昌盛	fcrv
舞台	fcsk
舞场	fctg
方	fd
失业	fdaa
短篇	fdad
雉	fdah
失策	fdah
知道	fdbh
失败	fdbw
失散	fdch
短期	fdcs
失色	fddb
失学	fddb
知觉	fddb
短	fddh
失效	fdeb
方兴未艾	fdec
失陷	fded
失望	fdeg
失职	fdek
智育	fdes
矩阵	fdev
短短	fdfd
短缺	fdfw
矧	fdga
短工	fdgh
方才	fdhg
方式	fdhg
智囊	fdhk
榘	fdhm
失	fdhn
矢	fdhn
方	fdhp
方面	fdhp
生态平衡	fdhp
知青	fdht
矩	fdhw
失灵	fdih
方针	fdjo
短路	fdka
短跑	fdka
失踪	fdka
失足	fdka
知	fdkh
方圆	fdkk
方形	fdkp
矩形	fdkp
智	fdkr
智力	fdlg
知音	fdlr
方根	fdmi
方格	fdmw
失眠	fdmw
失掉	fdoa
失措	fdoc
失礼	fdog
方示	fdoh
失声	fdoh
失真	fdok
失神	fdor
矫	fdpa
方向	fdpk
方程	fdpm
失利	fdpm
智利	fdpm
矮	fdpn
方便	fdrh
矢量	fdrh
矫健	fdri
短促	fdrk
方位	fdrl
矬	fdrt
失明	fdru
失信	fdry
智慧	fdsa
短波	fdsg
方法	fdst
智能	fdsu
失去	fdts
短暂	fdvj
短处	fdwa
失守	fdxc
知心	fdxd
矮小	fdxg
短小	fdxg
知名	fdxk
方案	fdxn
失常	fdxt
方言	fdyd
短评	fdyh
短语	fdyh
失误	fdyk
知识	fdyk
失调	fdyp
迭	fdzh
先进集体	fear
先进事迹	fehe
先进个人	ferr
生动活泼	fess
族	ff
旗	ffcb
旖	ffdg
旒	ffeg
族	fffd
旌	ffft
旅店	ffga
施	ffgg
施工	ffgh
旋	ffgr
旆	ffhj
旗袍	ffid
旋风	ffji
旗帜	ffjk
旋钮	ffjw
旗号	ffkh
施加	fflk
旗杆	ffme
旄	ffmg
旎	ffob
施展	ffoc
旗手	ffop
旅馆	ffox
旃	ffpe
旅	ffpn
旅行	ffpr
施行	ffpr
旋律	ffpr
膂	ffpu
旅途	ffre
族人	ffrp
旅游	ffsf
施用	ffua
施肥	ffub
旋转	ffve
旅长	ffvp
旅客	ffxw
旗子	ffzw
缸	fg
缸	fgah
迤	fgaz
乞	fgh
乞丐	fgha
乞求	fghg
迤逦	fghk
迄今	fgrd
迄	fgzh
年	fh
制止	fhaa
年	fhao
年龄	fhar
年关	fhbe
年限	fhei
制动	fhes
制造	fhfa
年年	fhfh
年度	fhgc
制度	fhgc
年底	fhgp
年下	fhha
年来	fhhb
年青	fhht
制表	fhht
年初	fhid
制	fhjd
制约	fhjd
年纪	fhjj
掣	fhjo
年级	fhjp
年终	fhjw
年号	fhkh
制品	fhkk
制图	fhkw
年间	fhmr
年岁	fhox
年份	fhrb
制作	fhrf
年代	fhrh
制件	fhrn
制裁	fhti
年老	fhtp
制服	fhue
年月	fhup
年成	fhvg
年轮	fhvr
年轻	fhvw
制剂	fhwp
制备	fhwt
制定	fhxh
制订	fhyh
先见之明	fkdr
旗开得胜	fkpu
生产关系	flbp
生产率	flew
生产方式	flfh
智力开发	flkw
生产资料	fllb
生产力	fllg
年产量	flrh
每	fm
繁荣	fmct
先睹为快	fmdx
毓	fmeg
每天	fmer
每年	fmfh
每	fmhd
繁殖	fmhx
敏锐	fmjb
每次	fmlq
敏捷	fmoh
繁重	fmph
每个	fmra
每人	fmrp
繁华	fmrq
敏感	fmvh
敏	fmwh
繁	fmwj
每逢	fmws
鳘	fmwu
繁琐	fmwx
繁忙	fmxe
每当	fmxi
繁多	fmxx
午	fo
午夜	foer
午	foha
卸	fohe
旗鼓相当	fomx
午饭	foop
午后	fopp
迕	foz
缶	fphh
复印机	fpmj
怎么样	fpmy
生气勃勃	fqoo
复	fr
复数	frbm
迄今为止	frda
复兴	frdb
於	frdd
每时每刻	frfe
复制	frfh
复习	frgl
复员	frkb
复查	frmr
复辟	frok
复古	frok
复印	frpg
复杂	frpg
先人后己	frpj
复合	frrh
复仇	frrp
复活	frsp
复写	frth
复原	frvb
复	frwh
复试	fryh
生活方式	fsfh
生活水平	fssh
生	ft
生前	ftbh
生态	ftdd
生效	fteb
生于	fteg
生动	ftes
生育	ftes
生病	ftgl
生来	fthb
生平	fthb
生	fthh
生死	fthx
生殖	fthx
生铁	ftjf
生锈	ftjp
生产	ftlp
生意	ftlr
眚	ftmh
生根	ftmi
生机	ftmj
生母	ftmw
生物	ftnd
生存	ftoa
生硬	ftoh
生气	ftqp
生日	ftra
年老体弱	ftrg
生命	ftrh
生活	ftsp
生涯	ftsv
甥	fttl
生成	ftvg
生长	ftvp
生疏	ftwa
生理	ftwr
生怕	ftxb
年轻人	fvrp
年轻化	fvrq
放	fw
缺点	fwah
放养	fwbs
缺勤	fwch
放过	fwcz
缺	fwda
放学	fwdb
放大	fwdh
缺陷	fwed
放弃	fwes
先发制人	fwfr
缺席	fwgc
放	fwgn
放肆	fwha
放下	fwha
放火	fwhd
放炮	fwhd
放风	fwji
缺口	fwka
放松	fwmb
放牧	fwnw
放射	fwoc
放热	fwop
放手	fwop
缺乏	fwpd
缺德	fwpr
放电	fwrg
放映	fwrk
缺货	fwrq
放假	fwrw
放水	fwsg
放置	fwso
放出	fwwa
放宽	fwxc
放心	fwxd
缺少	fwxp
年富力强	fxlg
知名人士	fxro
知识分子	fybz
知识化	fyrq
个	g
收	ga
收集	gaam
收购	gabd
收益	gabh
蛋白	gabp
引擎	gacd
收获	gacq
收藏	gacv
收效	gaeb
引进	gaep
卫队	gaer
收取	gaey
收复	gafr
卫生	gaft
也	gag
引	gag
收买	gagd
卫	gah
店	gahk
疋	gahr
收到	gahs
胥	gahu
蛋	gahv
引线	gaje
收缩	gajx
收听	gakj
收回	gakk
工业品	gakk
引见	gakp
引力	galg
收音	galr
也门	gamd
也好	ganz
收据	gaoo
收拾	gaor
收支	gaoy
引种	gapm
收入	gapn
引入	gapn
卫星	garf
收敛	garh
也是	garh
引人	garp
工业化	garq
引导	gasc
引渡	gasg
引水	gasg
引用	gaua
收成	gavg
收	gaw
引出	gawa
收录	gawe
收发	gawp
引发	gawp
收容	gaxr
收割	gaxs
引言	gayd
也许	gayf
引证	gayh
引诱	gayp
引起	gazj
弹	gb
弹簧	gbac
靶	gbag
弹药	gbcj
弹头	gbdd
廉	gbhb
贡	gbhd
弹力	gblg
鬻	gbma
粥	gbmg
贡献	gbok
庀	gbpg
庳	gbpo
弹	gbro
廉价	gbrr
弹奏	gbsr
弹性	gbxf
度	gc
度数	gcbm
工艺美术	gcbm
遮盖	gcbw
遮蔽	gccx
度过	gccz
庶	gchh
席	gchj
鹧	gchn
鞴	gcho
庹	gchr
廑	gcht
度	gchy
遮	gchz
工艺品	gckk
遮掩	gcod
鞯	gcoz
遮住	gcre
度量	gcrh
席位	gcrl
工艺流程	gcsp
席子	gczw
以北	gdae
以上	gdah
应战	gdah
应答	gdar
划分	gdbd
应邀	gdbf
应	gdbh
以前	gdbh
鞠	gdbm
买	gddd
划	gddg
广大	gddh
广义	gddi
以免	gddk
以为	gddl
广州	gddp
应变	gdea
广州市	gdej
广告	gdfa
广度	gdgc
以下	gdha
以来	gdhb
广	gdhp
以至	gdhs
以致	gdhs
广东	gdhw
以东	gdhw
廊	gdie
划线	gdje
鞔	gdkg
以内	gdkr
买办	gdlb
应力	gdlg
庆贺	gdlk
广阔	gdms
鞠躬	gdog
买卖	gdog
广博	gdoh
应声	gdoh
庆祝	gdok
以南	gdok
广播	gdop
应有	gdou
庆	gdpn
以后	gdpp
以往	gdpr
应得	gdpr
以及	gdpw
以	gdr
应付	gdrc
以便	gdrh
划清	gdsh
庖	gdsp
广泛	gdsp
广场	gdtg
应考	gdtp
应用	gdua
廨	gduo
买通	gdwd
以外	gdxa
广西	gdxh
划定	gdxh
应当	gdxi
鞫	gdya
应对	gdyc
应酬	gdyd
应该	gdye
鞑	gdza
应承	gdze
那	ge
工商业	geaa
那些	geab
邛	geea
那儿	geep
邡	gega
弭	gegh
廓	geke
廪	geko
那边	gelz
那样	gemy
引进技术	geom
邝	gepa
那	gepe
庑	gepg
那种	gepm
那么	geps
那个	gera
那时	gerc
那里	gert
弦	gews
卫生部	gflk
乙	gg
乜	gg
弛	ggag
应收账款	ggbo
引以为戒	ggdh
习以为常	ggdx
乙方	ggfd
乙烯	gghi
弛缓	ggja
应收款	ggos
痛痛快快	ggxx
乙醚	ggyb
乙醇	ggye
工	gh
革	ghaa
工业	ghaa
工	ghah
工龄	ghar
弼	ghbg
工艺	ghcg
工期	ghcs
鞲	ghct
工商	gheb
弋	ghgd
戈	ghgp
巧	ghgt
工序	ghgw
工匠	ghhj
工整	ghhk
工钱	ghje
司	ghk
工具	ghks
革新	ghlh
工资	ghlq
项目	ghma
司机	ghmj
工棚	ghmu
司马	ghmw
巧妙	ghnx
工矿	ghog
工友	ghoy
工段	ghpa
项	ghpb
工程	ghpm
工种	ghpm
工质	ghpp
工时	ghrc
司令	ghrd
工会	ghre
工作	ghrf
革命	ghrh
工件	ghrn
工人	ghrp
司法	ghst
工场	ghtg
工地	ghtg
工农	ghti
廒	ghtw
工厂	ghvh
工蜂	ghvw
司务	ghwl
广东省	ghxp
唐	gi
唐	giak
唐舟	giap
康	gign
康熙	giha
唐山	gioa
赓	girb
庸俗	girb
庚	girp
庸	giua
恐	gj
靳	gjaj
銎	gjdj
跫	gjdr
巩	gjdt
蛩	gjdv
恐	gjdx
恐吓	gjkh
巩固	gjko
庵	gjrp
庾	gjrp
恐怕	gjxb
恐慌	gjxc
恐惧	gjxk
恐怖	gjxo
强	gk
强占	gkah
强迫	gkbz
鞅	gkda
强大	gkdh
强制	gkfh
强度	gkgc
强弱	gkgl
强烈	gkhx
强国	gkkw
强壮	gkla
强加	gklk
强盗	gklq
强权	gkmy
庙	gkoh
强硬	gkoh
强碱	gkov
强行	gkpr
强电	gkrg
强化	gkrq
强	gkvg
强盛	gkvg
犟	gkvn
强调	gkyp
强酸	gkys
病	gl
疵	glab
弱点	glah
勒	glap
痱	glas
疼爱	glat
瘢	glay
瘘	glbn
瘿	glbn
瘅	glbo
疤	glbp
疗养	glbs
癀	glcb
瘼	glcd
疳	glce
瘩	glck
病菌	glck
痨	glcl
疾苦	glco
痛苦	glco
功劳	glct
疲劳	glct
痪	gldd
病态	gldd
疚	gldn
病房	gldo
痘	gldp
疱	glds
病危	gldv
病变	glea
痉挛	glea
功效	gleb
疗效	gleb
瘁	gleo
痕迹	glep
功夫	gler
痃	gles
疰	glet
癃	glet
疟	glew
功率	glew
瘾	glex
疾	glfd
瘀	glfd
痄	glfe
疙	glfg
痴	glfk
疖	glga
弱	glgl
羽	glgl
癌症	glgl
疤痕	glgl
病痛	glgl
病症	glgl
疙瘩	glgl
疾病	glgl
痢疾	glgl
疟疾	glgl
瘦弱	glgl
瘫痪	glgl
疼痛	glgl
痛痒	glgl
病床	glgm
疡	glgp
疲	glgy
症	glha
癞	glhb
瘌	glhd
疔	glhg
疴	glhg
痰	glhh
痖	glhh
痞	glhk
痦	glhk
瘃	glhn
疠	glhp
病	glhr
痍	glhr
瘗	glht
病毒	glht
痕	glin
痛斥	gljd
功绩	gljh
疯	glji
工资级别	gljk
瘐	gljr
瘦	gljy
疫	gljy
功勋	glkb
病因	glkd
痼	glkh
病号	glkh
痛哭	glkk
癌	glko
瘸	glkr
疽	glks
症状	glla
痂	gllk
瘴	gllo
癔	gllx
癯	glma
疾驰	glmg
痫	glmm
羽毛	glmp
癫	glob
疣	glog
病逝	gloj
病故	glok
癖	gloo
疝	glop
勒索	glot
痣	glox
癜	gloy
瘪	glpb
痢	glpd
疲乏	glpd
病重	glph
痿	glpn
瘤	glpt
疒	glpt
瘠	glpu
习气	glqp
疯狂	glqw
疥	glra
疲倦	glrb
习俗	glrb
瘊	glrd
习作	glrf
疮	glrg
弱电	glrg
疸	glrh
病例	glrh
痊愈	glrh
习题	glrh
瘟	glrm
疹	glrp
病人	glrp
痤	glrt
痊	glrw
病假	glrw
痧	glsp
疗法	glst
功能	glsu
瘛	glsx
习	glt
痔	gltc
瘰	gltj
功	gltp
痈	glua
功用	glua
癣	gluy
病原	glvb
疬	glvl
疼	glwd
痉	glwg
疗	glwg
痛	glwo
瘳	glwp
癍	glww
瘕	glwy
痴心	glxd
痛心	glxd
习性	glxf
弱小	glxg
瘦小	glxg
病情	glxh
痴情	glxh
痛恨	glxi
功名	glxk
瘭	glxo
瘵	glxo
病害	glxs
痛快	glxw
习惯	glxw
瘫	glya
瘥	glyg
痒	glyp
功课	glyr
弱酸	glys
瘙	glyv
疯子	glzw
床	gm
麻痹	gmbl
床单	gmbr
蘑菇	gmcn
麻烦	gmhh
床铺	gmjh
麻绳	gmjk
魔术	gmmd
麻木	gmmh
縻	gmmj
糜	gmmm
麾	gmmm
蘑	gmmo
磨	gmmo
摩	gmmo
麻	gmmp
靡	gmms
魔	gmms
麽	gmms
摩托	gmop
摩擦	gmox
摩尔	gmpg
床	gmpn
麻袋	gmrh
床位	gmrl
麻雀	gmxa
麻醉	gmye
以权谋私	gmyp
麻子	gmzw
迅	go
庞大	godh
庞	gogd
迅速	gohk
迅猛	goqx
工矿企业	gora
以身作则	gorb
庋	goyp
迅	goz
乃	gp
费	gpab
颇	gpab
艴	gpab
弗	gpag
飞船	gpaj
底盘	gpam
工程师	gpap
皮	gpay
皮带	gpca
飞	gpd
鞒	gpda
飞奔	gpdo
皮包	gpds
盈亏	gpeg
孕育	gpes
庭院	gpex
飞舞	gpfc
飞旋	gpff
弧度	gpgc
底	gpgd
皮革	gpgh
底座	gpgr
皮鞋	gpgt
弥	gpgx
底下	gpha
飞速	gphk
费事	gphk
乃至	gphs
弥补	gpia
底细	gpjt
飞跑	gpka
飞跃	gpka
弧形	gpkp
费力	gplg
底部	gplk
底边	gplz
飞驰	gpmg
飞机	gpmj
皮毛	gpmp
鼐	gpmw
孕妇	gpni
皮层	gpoe
飞扬	gpog
庭	gpoz
底片	gppa
底稿	gppm
盈利	gppm
弧	gppn
皮质	gppp
底行	gppr
飞行	gppr
乃是	gprh
弥漫	gpsr
费用	gpua
飞腾	gpub
皮肤	gpue
虱	gpv
飞轮	gpvr
费劲	gpwd
皮球	gpwh
尕	gpx
飞快	gpxw
戤	gpyg
飞翔	gpyg
盈	gpym
孕	gpz
飞越	gpzh
底子	gpzw
虱子	gpzw
鞭策	grah
鹰	gran
膺	grau
应付账款	grbo
腐败	grbw
府	grcp
腐	grcr
工人阶级	grej
靼	grha
腐烂	grhb
鞭炮	grhd
鞭	grhi
司令员	grkb
司令部	grlk
腐朽	grmh
庥	grmp
鞭打	groh
应付款	gros
腐蚀	grov
靴	grqa
工作人员	grrk
座位	grrl
工人日报	grro
腐化	grrq
革命化	grrq
座	grrt
引人注目	grsm
工作者	grtp
廛	grtt
革命家	grxh
座谈	gryh
鞭子	grzw
靴子	grzw
汞	gs
弘	gsgd
汞	gshn
司法部	gslk
刁	gt
工农业	gtaa
庄严	gtha
疆	gthh
庄园	gtke
庄	gtph
庄重	gtph
庄稼	gtpm
鞋	gtta
刁难	gtya
鞋子	gtzw
庄子	gtzw
应用科学	gupd
张大	gvdh
库房	gvdo
张望	gveg
张	gvgn
张力	gvlg
库存	gvoa
库	gvpa
库仑	gvrb
攻	gw
麟	gwaa
废止	gwaa
鹿	gwab
麒	gwab
麝	gwac
攻占	gwah
麂	gwaj
鏖	gwaj
麇	gwam
麋	gwam
麈	gwaw
攻关	gwbe
废料	gwbm
序幕	gwcr
序	gwdg
弪	gwdg
鞣	gwdm
攻陷	gwed
攻击	gweo
废除	gwer
废弃	gwes
麋鹿	gwgw
麒麟	gwgw
攻下	gwha
弓	gwhg
疲惫不堪	gwht
序列	gwhx
序号	gwkh
废品	gwkk
弓形	gwkp
廖	gwlp
收录机	gwmj
废物	gwnd
攻打	gwoh
攻克	gwok
废	gwpd
废气	gwqp
废水	gwsg
废墟	gwta
攻	gwtn
以理服人	gwur
攻守	gwxc
序言	gwyd
攻读	gwyo
废话	gwyp
废寝忘食	gxeo
广西壮族	gxlf
鞍	gxna
鞘	gxua
庠	gypa
或	h
正	ha
戬	haag
亚	haah
政策	haah
五彩	haam
晋	haar
垩	haat
下等	haat
严	haav
恶	haax
正比	habb
下贱	habe
正数	habm
下巴	habw
一般的说	haby
下落	hacs
下	had
到此为止	hada
正负	hadb
正义	hadi
下旬	hadr
鬓角	hadu
忑	hadx
下达	hadz
政变	haea
严防	haef
正规	haer
下降	haew
下方	hafd
下午	hafo
正午	hafo
下生	haft
正弦	hage
正巧	hagh
恶习	hagl
恶魔	hagm
亚麻	hagm
政府	hagr
正	hah
严正	haha
下来	hahb
鄢	hahe
丐	hahg
正式	hahg
焉	hahh
五一	hahh
严整	hahk
正事	hahk
政事	hahk
焯	haho
下面	hahp
正面	hahp
平等互利	hahp
恶毒	haht
不管不顾	hahv
下列	hahx
严肃	haia
正统	haje
晋级	hajp
五金	hajp
下级	hajp
正经	hajw
正中	haka
颐	hakb
赜	hakb
熙	hakh
噩	hakh
下同	hakh
正品	hakk
与此同时	hakr
下次	halq
恶意	halr
五音	halr
下边	halz
下棋	hamc
正门	hamd
严禁	hamm
正极	hamp
严格	hamw
政权	hamy
正如	hank
正好	hanz
下山	haoa
正在	haoa
正确	haod
下层	haoe
政局	haog
正视	haok
正直	haok
政协	haol
下手	haop
下属	haop
严峻	haos
晋升	hapc
严重	haph
政委	hapm
下垂	hapo
正反	happ
匪徒	hapr
五行	hapr
下行	hapr
正切	haqd
正气	haqp
下令	hard
觋	harg
正电	harg
巫	harh
五保	hark
恶果	harm
吾人	harp
恶化	harq
严明	haru
噩耗	hasa
髭	hasb
鬓	hasb
爝	hasc
亚洲	hasd
髡	hase
下流	hase
下游	hasf
鬈	hasg
鬣	hasg
下水	hasg
鬏	hash
鬟	hasi
髫	hask
髻	hask
下台	hask
髦	hasm
髹	hasm
肆	haso
鬃	haso
髟	hasp
正派	hasp
政治	hass
髯	hast
下沉	hast
政法	hast
匪	hasw
下场	hatg
下地	hatg
下去	hats
亚军	hatv
恶霸	haug
下肢	hauo
五月	haup
正月	haup
下车	havh
严厉	havh
政	haw
卧	hawd
下班	hawd
下文	hawd
严冬	hawd
正文	hawd
五	hawh
吾	hawk
政务	hawl
下发	hawp
臣	haww
下乡	haww
严守	haxc
恶心	haxd
严密	haxd
严实	haxd
恶性	haxf
卧室	haxh
下定	haxh
严寒	haxh
正当	haxi
五笔字型	haxk
恶劣	haxp
正常	haxt
政党	haxt
五官	haxw
政客	haxw
严酷	hayf
一般说来	hayh
来	hb
来临	hbaa
平等	hbat
百分比	hbbb
百分	hbbd
平分	hbbd
平巷	hbch
来过	hbcz
夹	hbd
颊	hbdb
郏	hbde
一分为二	hbde
平房	hbdo
夹角	hbdu
平方	hbfd
来年	hbfh
来生	hbft
平生	hbft
夹攻	hbgw
百	hbh
平平	hbhb
平炉	hbhd
平整	hbhk
百万	hbhp
平面	hbhp
来到	hbhs
平静	hbht
平素	hbht
燧	hbhz
平缓	hbja
平凡	hbjd
副总经理	hbjw
来回	hbkk
夹具	hbks
来意	hblr
来	hbm
赉	hbmb
平板	hbmp
百姓	hbnf
平	hbo
夹层	hboe
平分秋色	hbpd
夹杂	hbpg
百科	hbpm
来自	hbpm
平和	hbpm
平稳	hbpm
平息	hbpm
平移	hbpm
平反	hbpp
来得	hbpr
来往	hbpr
平衡	hbpr
平行	hbpr
平日	hbra
平时	hbrc
百倍	hbrl
百货	hbrq
百里	hbrt
来信	hbry
烂	hbsd
平淡	hbsh
平滑	hbsk
平台	hbsk
烂漫	hbsr
来源	hbsv
平均	hbtd
平壤	hbte
平地	hbtg
平坦	hbtr
平原	hbvb
来历	hbvl
平仄	hbvr
煌	hbwd
平民	hbwh
副总理	hbwr
百家	hbxh
平安	hbxn
来宾	hbxp
平常	hbxt
百官	hbxw
来访	hbyf
平话	hbyp
夹子	hbzw
煤	hc
不甘落后	hccp
烘干	hcea
甙	hced
煤	hcem
戒	hcgd
戒严	hcha
烘	hchb
觏	hchg
烘烤	hcht
遘	hchz
戒指	hcob
煤层	hcoe
煤矿	hcog
万荣南	hcok
煤碳	hcoo
煤炭	hcoo
匿	hcow
慝	hcox
煤质	hcpp
煤气	hcqp
煤油	hcsk
煤田	hcta
百花齐放	hcwf
煤球	hcwh
匿名	hcxk
卧薪尝胆	hcxu
炎黄子孙	hczz
火	hd
火柴	hdab
火箭	hdab
炉料	hdbm
燎	hdbx
火药	hdcj
火花	hdcr
灼	hddd
灬	hddd
不学无术	hdem
煽动	hdes
医学院	hdex
炮制	hdfh
炮弹	hdgb
火炉	hdhd
火炮	hdhd
火焰	hdhd
炉火	hdhd
炮火	hdhd
焰火	hdhd
炉顶	hdhg
火炬	hdhh
火烧	hdhh
求之不得	hdhp
炉灶	hdht
炉衬	hdic
焰	hdjd
火线	hdje
焕	hdkd
火力	hdlg
炉门	hdmd
火山	hdoa
火把	hdob
煸	hdoc
火苗	hdoc
炉	hdod
炮声	hdoh
煽	hdol
火热	hdop
灼热	hdop
匾	hdow
炮兵	hdpa
火	hdpp
火气	hdqp
火星	hdrf
炮	hdsd
炮台	hdsk
炉渣	hdsm
炉温	hdsr
火腿	hdui
炉膛	hdux
火车	hdvh
焕发	hdwp
火光	hdxh
火灾	hdxh
炉子	hdzw
匹	he
贰	hebd
熵	hebk
责无旁贷	heer
兀	heg
炕	hejd
不动声色	heod
炷	hetd
匹	hew
炫	hews
匹配	heyj
炸	hf
炸	hfae
医师	hfap
平方公里	hfbr
医药	hfcj
炸药	hfcj
医学	hfdb
翳	hfdl
医	hfdw
百年大计	hfdy
医院	hfex
医生	hfft
炸弹	hfgb
医疗	hfgl
炸毁	hfjg
医护	hfod
不知所措	hfpo
青年人	hfrp
医治	hfss
医务	hfwl
丁	hg
顶点	hgah
歌功颂德	hgbp
瓦斯	hgcs
与其	hgcs
才学	hgdb
求学	hgdb
顶头	hgdd
鸢	hgdn
顶角	hgdu
瓦解	hgdu
才干	hgea
顶替	hger
才智	hgfd
式	hggd
瓦	hggd
与	hgh
顶	hghb
求救	hghg
百废具兴	hgkd
求助	hgks
救国	hgkw
求	hgld
顶部	hglk
顶端	hglo
救	hglw
逑	hglz
顶板	hgmp
式样	hgmy
求婚	hgnp
瓦特	hgnt
救护	hgod
才有	hgou
顶峰	hgow
才	hgp
尧	hgpe
翘	hgpl
求和	hgpm
炀	hgpp
才气	hgqp
夷	hgr
顶住	hgre
与会	hgre
救星	hgrf
才华	hgrq
才能	hgsu
救济	hgsw
欤	hgtq
救灾	hgxh
求情	hgxh
顶多	hgxx
求证	hgyh
才识	hgyk
式子	hgzw
一	hh
一些	hhab
违背	hhae
一般	hhaj
焐	hhak
灯笼	hhao
一等	hhat
一半	hhbe
一道	hhbh
烧瓶	hhbk
一并	hhbk
一带	hhca
不求甚解	hhcd
一共	hhch
一举	hhdb
剡	hhdd
一头	hhdd
一套	hhdh
不正之风	hhdj
炎	hhdn
万事大吉	hhdo
一角	hhdu
一旁	hheb
郯	hhed
一天	hher
一阵	hhev
灭亡	hhew
一刻	hhew
一生	hhft
韦	hhga
一度	hhgc
灯	hhgd
韧	hhgd
烧	hhge
韬	hhgj
炎症	hhgl
韫	hhgm
违	hhgz
炜	hhha
一下	hhha
灯火	hhhd
灭火	hhhd
烧火	hhhd
一一	hhhh
烦燥	hhhk
一再	hhhk
焱	hhhn
一面	hhhp
一致	hhhs
不可否认	hhhy
一线	hhje
炼铁	hhjf
烧毁	hhjg
炼钢	hhjk
烧结	hhjo
一口	hhka
一路	hhka
炊事员	hhkb
一曲	hhkc
炳	hhkr
一端	hhlo
一次	hhlq
一瞬	hhma
烧杯	hhmh
一概	hhmi
一样	hhmy
素不相识	hhmy
灭	hhn
烧饼	hhob
违抗	hhoe
一直	hhok
熙熙攘攘	hhoo
炎热	hhop
一身	hhop
一手	hhop
烧碱	hhov
一片	hhpa
烦	hhpb
一番	hhpb
一向	hhpk
一种	hhpm
违反	hhpp
来来往往	hhpp
一律	hhpr
一行	hhpr
一切	hhqd
违犯	hhqg
一气	hhqp
一个	hhra
一日	hhra
一旦	hhrh
面面俱到	hhrh
一体	hhrm
一早	hhro
万事俱备	hhrw
灯泡	hhsd
炼油	hhsk
违法	hhst
一堆	hhta
灯塔	hhtc
不可思议	hhty
一月	hhup
烧成	hhvg
一连	hhvz
炼	hhwb
炖	hhwg
一发	hhwp
一齐	hhwp
炬	hhww
灯丝	hhww
一贯	hhww
一心	hhxd
烦恼	hhxe
韧性	hhxf
灯光	hhxh
一定	hhxh
一起	hhzj
区	hi
妻	hian
区分	hibd
爽朗	hidi
煺	higz
爽	hiir
区别	hikl
区间	himr
欧姆	hinm
殴打	hioh
烯	hioj
区委	hipm
欧洲	hisd
区域	hith
区	hiw
瓯	hiwd
鸥	hiwn
欧	hiwq
殴	hiwy
爽快	hixw
妻子	hizw
刺	hj
棘	hjbb
青红皂白	hjbb
刺	hjbd
枣	hjbd
刺刀	hjdg
不约而同	hjhk
歪风邪气	hjhq
刺骨	hjkw
刺激	hjsb
匠	hjw
匝	hjw
匠心	hjxd
两	hk
整	hkaa
副业	hkaa
事业	hkaa
赖	hkab
束	hkab
剌	hkad
哥	hkag
囊	hkai
橐	hkam
可笑	hkap
歌	hkaq
可爱	hkat
遭受	hkat
蠹	hkav
匮	hkaw
敕	hkaw
速	hkaz
柬	hkbb
炽	hkbd
可疑	hkbf
可逆	hkbh
事前	hkbh
整数	hkbm
歌颂	hkbs
逼迫	hkbz
曹	hkcr
烟草	hkcr
遭	hkcz
丽	hkdd
两头	hkdd
郦	hkde
烟	hkdh
整套	hkdh
鹂	hkdn
逦	hkdz
副刊	hkea
可变	hkea
可耻	hkea
事变	hkea
两旁	hkeb
可望	hkeg
事迹	hkep
整除	hker
整天	hker
速率	hkew
可取	hkey
可靠	hkfa
事先	hkfa
歌舞	hkfc
可知	hkfd
再生	hkft
可	hkg
速度	hkgc
再度	hkgc
可以	hkgd
两广	hkgd
事项	hkgh
可恶	hkha
一国两制	hkhf
哥哥	hkhk
事事	hkhk
整整	hkhk
两面	hkhp
可不	hkhr
再不	hkhr
遭到	hkhs
整顿	hkhw
炽烈	hkhx
遭殃	hkhx
吏	hki
事	hkig
束缚	hkjh
整风	hkji
不同凡响	hkjk
逼近	hkjz
鬲	hkka
可贵	hkka
可口	hkka
歌曲	hkkc
炯	hkkd
歌咏	hkkd
翮	hkkl
燥	hkkm
事由	hkko
烟叶	hkko
可见	hkkp
再见	hkkp
整形	hkkp
歌唱	hkkr
融	hkkv
两国	hkkw
两端	hklo
再次	hklq
两边	hklz
两相	hkmm
两极	hkmp
两样	hkmy
事物	hknd
可喜	hkod
歌声	hkoh
逼真	hkok
事故	hkok
歌剧	hkoo
炽热	hkop
副食	hkop
两手	hkop
再版	hkpa
不由自主	hkpe
烟囱	hkpk
两种	hkpm
事后	hkpp
可行	hkpr
丙	hkr
两个	hkra
整个	hkra
整修	hkra
逼供	hkrc
邴	hkre
再会	hkre
烟袋	hkrh
逼债	hkrh
或是	hkrh
可是	hkrh
融合	hkrh
事例	hkrh
遭遇	hkrk
整体	hkrm
事件	hkrn
融化	hkrq
两	hkrr
整流	hkse
再三	hksh
烟台	hksk
整洁	hkso
融洽	hksr
整治	hkss
可能	hksu
再	hkt
副	hktd
或	hktd
速写	hkth
或者	hktp
两者	hktp
惑	hktx
逼	hktz
烟雾	hkuw
速成	hkvg
叵	hkw
再现	hkwk
事务	hkwl
整齐	hkwp
整理	hkwr
可怕	hkxb
可憎	hkxb
可惜	hkxc
事实	hkxd
事情	hkxh
可恨	hkxi
事宜	hkxk
可怜	hkxr
烟尘	hkxt
整党	hkxt
歌谣	hkya
再说	hkyb
或许	hkyf
歌词	hkyg
可观	hkyk
可调	hkyp
可谓	hkyt
焙	hlkd
更新换代	hlor
末	hm
不相上下	hmah
互相爱护	hmao
两极分化	hmbr
末期	hmcs
末年	hmfh
可想而知	hmhf
戒骄戒躁	hmhk
一概而论	hmhy
末	hmn
末尾	hmom
末日	hmra
互相帮助	hmsk
末了	hmwg
一目了然	hmwx
焖	hmxd
严格要求	hmxh
灿	hoda
炻	hodh
一技之长	hodv
戎	hogd
灿烂	hohb
百折不挠	hoho
再接再厉	hohv
煳	hoku
烬	hond
不择手段	hoop
政协委员	hopk
来龙去脉	hotu
不拘小节	hoxc
面	hp
丌	hpa
面临	hpaa
逐步	hpaa
煅	hpay
页	hpb
万分	hpbd
烀	hpbg
面前	hpbh
面粉	hpbm
燔	hpbt
万世	hpch
耐劳	hpct
面色	hpdb
万象	hpdk
耐久	hpdn
面包	hpds
面熟	hpek
迈进	hpep
夏天	hper
万年	hpfh
逐年	hpfh
万	hpg
夏收	hpga
燹	hpgh
劢	hpgl
耐磨	hpgm
豕	hpgn
熘	hpgt
虿	hpgv
虺	hpgv
迈	hpgz
逐	hpgz
万恶	hpha
耐火	hphd
耐烦	hphh
万一	hphh
熄灭	hphh
煅烧	hphh
万万	hphp
逐级	hpjp
而	hpka
耐	hpkc
燠	hpkd
面	hpkh
面团	hpkh
耍	hpkn
鸸	hpkn
趸	hpkr
而且	hpks
面具	hpks
恧	hpkx
耐力	hplg
面部	hplk
面目	hpma
戛	hpmg
面相	hpmm
夏	hpmw
熄	hpmx
万物	hpnd
页岩	hpoo
耐热	hpop
万岁	hpox
面貌	hppd
面积	hppm
夏季	hppm
万千	hppo
而后	hppp
逐个	hpra
而今	hprd
而是	hprh
万能	hpsu
逐渐	hpsv
万幸	hptb
耐用	hpua
万历	hpvl
而已	hpwh
烁	hpwx
耐心	hpxd
耐性	hpxf
可行性	hpxf
耐寒	hpxh
面容	hpxr
面对	hpyc
耐酸	hpys
面孔	hpzg
面子	hpzw
炊	hqdn
炊事	hqhk
不切实际	hqxe
还	hr
不止	hraa
不妥	hran
爆竹	hrap
不符	hrar
不等	hrat
匣	hraw
惠	hrax
不管	hrax
不分	hrbd
否则	hrbd
百货公司	hrbg
不曾	hrbk
不断	hrbm
不料	hrbm
不单	hrbr
不公	hrbs
爆	hrcd
不甘	hrce
不过	hrcz
不	hrd
歪	hrda
不忍	hrdd
邳	hrde
不必	hrdg
丕	hrdh
不大	hrdh
不良	hrdi
否	hrdk
焓	hrdk
不够	hrdk
不免	hrdk
不久	hrdn
甭	hrdo
不解	hrdu
与人为善	hrdy
还	hrdz
焊	hrea
不变	hrea
百货商店	hreg
还击	hreo
不无	hrep
烩	hres
责任制	hrfh
来日方长	hrfv
炝	hrgg
不巧	hrgh
亘	hrh
更正	hrha
不平	hrhb
爆炸	hrhf
不一	hrhh
不可	hrhk
来人来函	hrhw
求全责备	hrhw
更	hri
不灵	hrih
求伯君	hrik
不错	hrjc
歪风	hrji
平易近人	hrjr
更改	hrjw
不足	hrka
不只	hrkb
歪曲	hrkc
不见	hrkp
不准	hrla
煜	hrld
更新	hrlh
更加	hrlk
否决	hrlw
不朽	hrmh
不问	hrmk
不禁	hrmm
郾	hrne
不妨	hrnf
不如	hrnk
孬	hrnz
还好	hrnz
不在	hroa
更换	hrod
爆破	hrog
焊接	hrol
不尽	hron
不振	hrov
不屈	hrow
不屑	hrox
不乏	hrpd
不和	hrpm
不利	hrpm
不适	hrpo
不待	hrpr
不得	hrpr
不行	hrpr
不及	hrpw
烨	hrqo
不独	hrqv
不时	hrrc
不会	hrre
歪斜	hrre
不便	hrrh
不合	hrrh
不是	hrrh
还是	hrrh
不依	hrri
不休	hrrm
不值	hrro
不但	hrrr
不明	hrru
不仅	hrry
不满	hrsc
不法	hrst
不能	hrsu
熳	hrsy
不幸	hrtb
不堪	hrtc
不用	hrua
不服	hrue
不胜	hruf
还原	hrvb
不成	hrvg
不顾	hrvg
不通	hrwd
不予	hrwd
不敢	hrwe
不已	hrwh
焊条	hrwh
爆发	hrwp
不理	hrwr
不备	hrwt
不外	hrxa
不怕	hrxb
不愧	hrxb
不惜	hrxc
不然	hrxd
不忙	hrxe
不定	hrxh
不光	hrxh
否定	hrxh
不当	hrxi
不宜	hrxk
不安	hrxn
不要	hrxn
不慎	hrxo
不少	hrxp
不容	hrxr
不肖	hrxu
不懈	hrxu
不快	hrxw
不善	hryb
不对	hryc
不该	hrye
不许	hryf
不配	hryj
不计	hryo
不论	hryr
否认	hryr
不详	hryy
到	hs
至此	hsab
至上	hsah
致敬	hscd
到期	hscs
到达	hsdz
至于	hseg
致病	hsgl
到底	hsgp
到来	hshb
到顶	hshg
政治面目	hshm
不三不四	hshs
致死	hshx
致力	hslg
政治部	hslk
致意	hslr
万润南	hsok
到手	hsop
政治协商会议	hsoy
违法乱纪	hspj
至今	hsrd
到会	hsre
致电	hsrg
致命	hsrh
致使	hsrh
到任	hsrp
到货	hsrq
至	hst
到	hstd
郅	hste
到场	hstg
致	hstw
到处	hswa
致密	hsxd
可能性	hsxf
到家	hsxh
致富	hsxh
至少	hsxp
青海省	hsxp
至多	hsxx
致词	hsyg
致谢	hsyo
表	ht
静止	htaa
画笔	htam
责	htb
表弟	htbg
表白	htbp
青菜	htca
毒药	htcj
青草	htcr
表态	htdd
灶	htdh
表象	htdk
表达	htdz
青年	htfh
表皮	htgp
烤烟	hthk
煨	hthn
来者不拒	htho
表面	hthp
画面	hthp
毒素	htht
静静	htht
表	hti
素	htj
画幅	htjh
青铜	htjk
青绿	htjw
毒品	htkk
责骂	htkk
画图	htkw
毒辣	htlo
表彰	htlr
表决	htlw
毒	htm
表述	htmd
纛	htmj
责问	htmk
表格	htmw
表妹	htne
青山	htoa
素描	htoc
表层	htoe
画报	htoe
表扬	htog
表示	htoh
毒手	htop
赘	htpb
聱	htpe
烤	htpg
表册	htpg
青岛	htpg
熬	htph
鏊	htpj
骜	htpm
素质	htpp
獒	htpq
鳌	htpu
螯	htpv
敖	htpw
遨	htpz
画像	htrd
静电	htrg
责任	htrp
表里	htrt
表明	htru
青海	htsf
青春	htsr
画法	htst
表演	htsx
青	htu
静脉	htud
静	htug
靓	htug
青鱼	htup
靛	htur
责成	htvg
静压	htvt
青蛙	htvt
毒蛇	htvx
麦	htw
画	htwa
麸	htwd
表现	htwk
责备	htwt
毒性	htxf
表情	htxh
画家	htxh
毒害	htxs
麦子	htzw
甫	hu
甫	huad
敷	huaw
逋	huaz
敷衍	hupr
敷设	huyj
烛	hvdd
匦	hvpw
烛光	hvxh
东	hw
匚	hw
顿	hwab
东北	hwae
屯	hwag
牙齿	hwar
顿首	hwbh
炔	hwdd
燃眉之急	hwdd
烃	hwdg
巨大	hwdh
东京	hwek
牙膏	hwek
东方	hwfd
雅	hwga
邪	hwge
鸦	hwgn
牙	hwgp
迓	hwgz
东晋	hwha
东亚	hwha
烽火	hwhd
东欧	hwhi
东面	hwhp
巨	hwhw
烙铁	hwjf
东风	hwji
雅典	hwkc
烙	hwkd
巨型	hwkd
互助	hwks
熠	hwlb
东部	hwlk
东边	hwlz
互相	hwmm
互换	hwod
东南	hwok
鸦片	hwpa
烙印	hwpg
互利	hwpm
顿时	hwrc
巨人	hwrp
烽	hwsa
东海	hwsf
顿河	hwsh
东汉	hwsy
屯田	hwta
匡	hww
不了了之	hwwd
互	hwwh
东	hwx
东家	hwxh
东西	hwxh
鸫	hwxn
巨额	hwxw
熔点	hxah
事实上	hxah
殍	hxaz
死	hxb
燃料	hxbm
殚	hxbo
殡葬	hxch
歹	hxd
列	hxd
列举	hxdb
残忍	hxdd
烈	hxdh
燃	hxdh
裂	hxdi
殉	hxdr
裂解	hxdu
裂变	hxea
残	hxed
列宁主义	hxed
烷	hxee
死亡	hxew
裂隙	hxex
青少年	hxfh
殇	hxfp
残缺	hxfw
列席	hxgc
忒	hxgd
列强	hxgk
残疾	hxgl
残废	hxgw
烈火	hxhd
煊	hxhh
歼灭	hxhh
燃烧	hxhh
熔炼	hxhh
熔融	hxhk
一心一意	hxhl
不寒而栗	hxhx
或多或少	hxhx
残杀	hxih
裂缝	hxjw
裂纹	hxjw
殁	hxjy
裂口	hxka
殒	hxkb
殃	hxkd
死刑	hxkd
殂	hxks
死板	hxmp
殊	hxnb
残存	hxoa
殪	hxod
残局	hxog
烈士	hxoh
殖	hxos
炒	hxpd
残留	hxpg
列入	hxpn
歼	hxpo
恶性循环	hxpw
烈日	hxra
残暴	hxrc
残余	hxre
死伤	hxrf
殓	hxrh
熔	hxrk
餮	hxro
殄	hxrp
熔化	hxrq
殆	hxsk
死活	hxsp
列车	hxvh
列出	hxwa
殛	hxwh
殖民	hxwh
殡	hxxb
烈性	hxxf
残害	hxxs
残酷	hxyf
烊	hyda
不言而喻	hyhk
不谋而合	hyhr
燮	hyhy
不着边际	hyle
五讲四美	hysb
以	i
补	ia
褴	iaam
补贴	iaba
补	iadd
补充	iaes
褙	iaeu
补习	iagl
肀	iah
补正	iaha
补救	iahg
肃静	iaht
补给	iajr
补品	iakk
补助	iaks
肃立	iald
建筑材料	iamb
建筑物	iand
肃	iapb
补血	iapm
肃穆	iapm
补偿	iarx
肃清	iash
补考	iatp
补发	iawp
补课	iayr
裕	ib
袢	ibea
褛	ibmn
裨	ibpo
裕	ibrk
寻	ic
寻觅	icak
衬	icdd
寻	ichd
寻求	ichg
衬衣	icid
衬衫	icip
寻找	icog
衬托	icop
褡	icrk
寻常	icxt
初	id
初步	idaa
初等	idat
衣料	idbm
初期	idcs
刈	iddg
初	iddp
初速	idhk
衣	idhp
衣襟	idim
初级	idjp
初中	idka
初次	idlq
初始	idns
褊	idoc
衣食	idop
初稿	idpm
袍	idsd
衣服	idue
衤	idwa
衣裳	idxt
初试	idyh
衣着	idym
建	ie
建筑	ieag
聿	ieah
建	ieaz
建交	ieeb
建造	iefa
建国	iekw
建立	ield
建材	iemh
建成	ievg
建议	ieyd
建设	ieyj
灵敏度	ifgc
被	ig
退步	igaa
被单	igbr
被迫	igbz
退色	igdb
即	igde
既	igdg
暨	igdh
被动	iges
即刻	igew
被告	igfa
退火	ighd
恳求	ighg
退还	ighr
退缩	igjx
退回	igkk
襁	igkv
即将	igla
隶	igln
逮	iglz
退换	igod
被捕	igoh
逮捕	igoh
隶属	igop
艮	igpn
垦	igpt
恳	igpx
被	igpy
退	igpz
恳切	igqd
被俘	igra
即日	igra
即便	igrh
即使	igrh
即位	igrl
退位	igrl
退休	igrm
退化	igrq
退货	igrq
退却	igts
裤	igvd
退出	igwa
既然	igxd
既定	igxh
退让	igya
被子	igzw
裤子	igzw
杀	ih
灵芝	ihcd
杀菌	ihck
灵魂	ihes
灵敏	ihfm
灵巧	ihgh
灵	ihhn
杀青	ihht
杀死	ihhx
袜	ihmd
杀伤	ihrf
杀人	ihrp
灵活	ihsp
裱	ihti
灵感	ihvh
刹车	ihvh
灵通	ihwd
杀	ihxd
刹	ihxd
弑	ihxd
杀害	ihxs
袜子	ihzw
裙	ii
爻	iidn
裉	iign
褪	iigz
裙	iikd
裙子	iizw
群	ik
裔	ikbk
群落	ikcs
郡	ikep
君主	iket
君权	ikmy
袖	ikoh
群岛	ikpg
君	ikph
衲	ikrd
群体	ikrm
群众	ikrr
裎	ikwd
群	ikyp
君子	ikzw
袖子	ikzw
襟	im
灵机一动	imhe
襻	imio
襟	immo
裥	imrd
希	io
希望	ioeg
希	iojd
郗	ioje
欷	iojq
裾	iook
衣食住行	iorp
郄	iose
希罕	iotb
希腊	iouc
肴	ioud
衫	ip
袄	ipdd
乂	ipnc
灵丹妙药	ipnc
衽	ipoh
褫	ippj
衫	ippp
褐	ir
裼	irdp
褐	irdw
衿	irdw
袒	irhd
裣	irhh
袷	irhk
群众路线	irkj
褓	irkm
裸	irmd
袒护	irod
袱	irqd
裸体	irrm
裸露	iruk
群众观点	irya
褂	it
帚	itjh
褚	itpr
褂	ittd
襦	iuha
褥	iv
褥	ivec
裢	ivzd
凶	iw
凶	iwad
袂	iwdd
凶险	iwer
凶恶	iwha
尹	iwhh
彐	iwhh
袼	iwkd
褶	iwlb
凶手	iwop
凶狠	iwqi
凶猛	iwqx
裆	ixid
襟怀坦白	ixtb
衩	iydd
杀鸡取蛋	iyeg
裰	iyyy
就	j
维	ja
幞	jaad
镤	jaad
缆	jaag
帷	jaah
铿	jaat
统筹兼顾	jabv
锊	jacg
缓期	jacs
钻头	jadd
钋	jadg
缓解	jadu
钻井	jaep
缓	jaey
锾	jaey
巾	jaga
锥	jagh
镌	jagp
帧	jahb
帖	jahk
钻	jahk
绰	jaho
铿锵	jajl
维纶	jajr
绰号	jakh
锥形	jakp
维新	jalh
缓冲	jalk
绥	jant
维护	jaod
钻研	jaok
维持	jaot
钻探	jaot
缓和	japm
综上所述	japm
维修	jara
绯	jass
维	jath
绶	jaty
缓慢	jaxr
叟	jayh
继	jb
帕	jbah
镨	jbar
锴	jbbb
缨	jbbn
纰	jbbt
缴获	jbcq
铡	jbdg
纷	jbdt
锐角	jbdu
绊	jbea
绻	jbeg
缴	jbfw
钡	jbgd
钯	jbgg
铂	jbgh
锑	jbgp
绨	jbgp
纷飞	jbgp
缣	jbhb
缢	jbhm
镒	jbhm
纷纷	jbjb
锦	jbjg
缴纳	jbjk
继续	jbjo
锦绣	jbjp
锦纶	jbjr
绵	jbjt
锐	jbke
缯	jbkr
铁道部	jblk
缕	jbmn
镂	jbmn
继	jbmw
锐利	jbpm
纷乱	jbpo
镁	jbwd
凰	jbwg
绵羊	jbyd
继承	jbze
错	jc
镬	jcay
错落	jccs
错过	jccz
错觉	jcdb
钳	jceg
绀	jcet
舁	jcha
错	jchr
绁	jchw
错开	jckh
锘	jcok
镆	jcrd
错位	jcrl
纣	jctd
锚	jctg
铹	jctl
错处	jcwa
错案	jcxn
错怪	jcxy
错误	jcyk
钳子	jczw
约	jd
斥	jda
约占	jdah
铯	jdbg
绝	jdbt
镣	jdbx
缭	jdbx
约莫	jdcr
编著	jdct
绍兴	jddb
钓	jddg
钛	jddg
钭	jddo
纫	jddt
约	jddt
绝交	jdeb
绔	jdeg
绝望	jdeg
绝迹	jdep
编造	jdfa
编制	jdfh
凡	jdg
铋	jdgd
钊	jdgg
绮	jdhg
舄	jdhh
凡事	jdhk
绚丽	jdhk
约束	jdhk
斥责	jdht
铮	jdig
锒	jdin
绉	jdit
缭绕	jdjh
编织	jdjk
绝缘	jdjw
编号	jdkh
绍	jdkt
绝大部分	jdlb
钧	jdlg
绝妙	jdnx
编排	jdoa
编	jdoc
锛	jdoc
改头换面	jdoh
绝壁	jdok
编码	jdom
编剧	jdoo
绝热	jdop
约有	jdou
编程	jdpm
编入	jdpn
锪	jdpx
约会	jdre
凡是	jdrh
约旦	jdrh
绚	jdrt
编导	jdsc
钩	jdsg
约法	jdst
绍酒	jdsy
编写	jdth
编者	jdtp
编辑	jdvk
绝大多数	jdxb
绝密	jdxd
约定	jdxh
绝对	jdyc
编订	jdyh
编译	jdyy
钩子	jdzw
线	je
统战	jeah
统筹	jeas
统购	jebd
镑	jebf
锩	jebg
钱财	jebh
铰	jebi
绞	jebi
缔	jebj
镝	jebk
统率	jeew
缔造	jefa
统制	jefh
钱	jegd
线	jegd
铒	jegh
纡	jegt
锕	jehg
统一	jehh
缡	jeis
缔约	jejd
统统	jeje
钪	jejg
铈	jejg
缔结	jejo
铰链	jejv
线路	jeka
线圈	jekb
线型	jekd
镶	jeki
锿	jeki
镐	jekk
缟	jekk
镦	jekw
镶嵌	jeoc
线索	jeot
线段	jepa
统称	jepm
统领	jerd
统	jese
铳	jese
锍	jesg
统帅	jesp
统治	jess
纭	jest
绞车	jevh
线条	jewh
铉	jews
线性	jexf
统计	jeyo
镊	jeyy
镊子	jezw
铁	jf
缵	jfab
铣	jfae
锆	jfak
铁道	jfbh
帙	jfda
铁	jfdg
铣刀	jfdg
镞	jffd
镟	jffr
钫	jfgg
纥	jfgt
铁匠	jfhj
纺织	jfjk
纺纱	jfjx
铁路	jfka
铁板	jfmp
铁饼	jfob
铁矿	jfog
铁水	jfsg
纺	jftg
纺车	jfvh
铁轨	jfvp
铁丝	jfww
铁心	jfxd
红	jg
纠集	jgam
纠	jgat
镰	jgbb
红茶	jgcr
红花	jgcr
镀	jgcy
红色	jgdb
鼢	jgdd
鼷	jgdd
鼠	jgdg
镰刀	jgdg
鼬	jgdh
鼯	jgdk
鼹	jgdn
红旗	jgff
钆	jgg
钇	jgg
纠正	jgha
毁灭	jghh
镛	jgio
纠纷	jgjb
红线	jgje
纠缠	jgjg
缠绕	jgjh
毁	jgjy
镪	jgkv
红松	jgmb
红娘	jgnd
绋	jgpa
镄	jgpb
红利	jgpm
帔	jgpy
铍	jgpy
缠	jgrt
红海	jgsf
铺张浪费	jgsg
缂	jgta
红	jgth
毁坏	jgth
纩	jgtp
红军	jgtv
镳	jgwh
红光	jgxh
练	jh
钙	jhag
钲	jhag
改邪归正	jhah
缙	jhar
铗	jhbd
铼	jhbm
纯粹	jhbm
铺盖	jhbw
缅甸	jhdt
钝角	jhdu
纯度	jhgc
幅度	jhgc
纬度	jhgc
钺	jhgd
绕	jhge
铙	jhge
钉	jhgg
练习	jhgl
钬	jhgn
铺张	jhgv
纬	jhha
帏	jhha
纯正	jhha
锬	jhhg
纬线	jhje
绕组	jhjk
缰绳	jhjk
镉	jhka
钶	jhkg
幅	jhkt
钷	jhkw
纯净	jhld
纯朴	jhma
绒毛	jhmp
绒	jhod
纯真	jhok
纯碱	jhov
练兵	jhpa
颀	jhpb
缅	jhph
纯利	jhpm
钚	jhrd
绠	jhri
铺位	jhrl
纯洁	jhso
绩	jhtb
帻	jhtb
缰	jhth
锖	jhtu
缚	jhuc
铺	jhud
练	jhwb
铘	jhwe
纯	jhwg
钝	jhwg
钜	jhww
铽	jhxd
夙	jhxg
缅怀	jhxh
铺设	jhyj
钉子	jhzw
风	ji
风筝	jiad
风箱	jiam
键盘	jiam
银白	jibp
银幕	jicr
风头	jidd
风扇	jido
飑	jids
风险	jier
风云	jies
键	jiez
风度	jigc
风	jigd
铱	jign
银	jign
飚	jihh
风速	jihk
铩	jihx
飕	jijy
风口	jika
飓	jikb
风味	jike
风力	jilg
风姿	jilq
风门	jimd
风格	jimw
银矿	jiog
风声	jioh
银川	jipa
银牌	jipa
风向	jipk
键入	jipn
银行	jipr
风气	jiqp
风俗	jirb
风暴	jirc
风景	jire
风量	jirh
风化	jirq
风浪	jisd
风流	jise
风波	jisg
银河	jish
风潮	jiso
风沙	jisx
锓	jity
风雨	jiuh
风压	jivt
风琴	jiww
风光	jixh
风尚	jixk
风尘	jixt
风趣	jize
银子	jizw
铅	jj
铅笔	jjam
锼	jjay
帆	jjda
钒	jjdg
纪元	jjee
近几年来	jjfh
错综复杂	jjfp
纺织工业部	jjgl
继续革命	jjgr
鑫	jjjh
组织纪律	jjjp
铅	jjkg
纺织品	jjkk
组织部	jjlk
缝纫机	jjmj
针锋相对	jjmy
帆布	jjoj
欣欣向荣	jjpc
纪委	jjpm
纪律	jjpr
锨	jjqg
纪念	jjrd
纪	jjtg
纪录	jjwe
铅球	jjwh
纪要	jjxn
组	jk
缋	jkab
钟	jkag
钢笔	jkam
钢筋	jkau
钢管	jkax
缱	jkaz
帜	jkba
织	jkbt
锄头	jkdd
钟头	jkdd
铟	jkdh
缉	jket
织造	jkfa
锅炉	jkhd
铜	jkhk
钟表	jkht
钢	jkig
纲	jkit
铜钱	jkje
钢铁	jkjf
铞	jkjg
组织	jkjk
钢锭	jkjx
组员	jkkb
铝	jkkg
锷	jkkg
缲	jkkm
锅	jkkr
组装	jkla
钢材	jkmh
织机	jkmj
钢板	jkmp
铜板	jkmp
织物	jknd
铀	jkoh
锢	jkoh
织布	jkoj
绳索	jkot
铜牌	jkpa
纳税	jkpm
纳入	jkpn
纲领	jkrd
钠	jkrg
绳	jkrg
组合	jkrh
纳	jkrt
钢水	jksg
锄	jksl
组	jkst
绢	jkut
组成	jkvg
钢轨	jkvp
组长	jkvp
锃	jkwg
帼	jkwh
钢琴	jkww
钢丝	jkww
纲要	jkxn
绳子	jkzw
镜	jl
锵	jlac
镜头	jldd
铲除	jler
锫	jlkg
锌	jlog
镜片	jlpa
铲	jlpg
镜	jlre
幛	jlro
幢	jlrt
镱	jlrx
铲子	jlzw
镜子	jlzw
朵	jm
剁	jmdw
钔	jmgg
钼	jmgh
镧	jmhb
钵	jmhg
锎	jmkg
缃	jmmt
锏	jmrg
朵	jmwn
缈	jmxp
铢	jnbg
钕	jngh
铷	jnkg
结	jo
结业	joaa
结算	joam
锯齿	joar
铌	jobg
结账	jobv
针灸	jodd
针	joga
续	jogd
锔	jogk
缬	johb
结	johk
结束	johk
幄	joht
镇静	joht
针线	joje
钸	jojg
铠	jojg
针织	jojk
镇	jokb
缜	jokb
钴	jokg
结冰	jols
结构	jomd
结婚	jonp
结局	joog
结石	jooh
锯	jook
结合	jorh
结果	jorm
结晶	jorr
结盟	joru
镇江	josg
结膜	jouc
铕	joug
镇压	jovt
结实	joxd
镇定	joxh
针对	joyc
绂	joyd
钹	joyd
结论	joyr
级	jp
钏	jpaa
臼	jpaw
锻	jpay
缎	jpay
几分	jpbd
银行账号	jpbk
级数	jpbm
幡	jpbt
金黄	jpch
绣花	jpcr
金色	jpdb
纸头	jpdd
银川市	jpej
锻造	jpfa
几	jpg
纨	jpgd
铆	jpge
纸	jpgg
钨	jpgh
绸	jpgk
镏	jpgt
纸张	jpgv
钅	jphh
锤炼	jphh
锻炼	jphh
金融	jphk
纸烟	jphk
锺	jpht
纤维	jpja
金钱	jpje
铆钉	jpjh
金银	jpji
绸缎	jpjp
级别	jpkl
铫	jpld
金边	jplz
锻模	jpmc
锹	jpmh
镍	jpmm
锈	jpmp
绣	jpmp
金	jpnh
锇	jpod
钎	jpog
锤	jpoh
缍	jpoh
锸	jpoj
金属	jpop
纤	jpot
铤	jpoz
金牌	jppa
纸片	jppa
几乎	jppb
斤	jpph
纸币	jppj
钐	jppp
钣	jppy
几时	jprc
金星	jprf
绗	jprg
几何	jprh
锻件	jprn
铥	jpts
金鱼	jpup
锻压	jpvt
级	jpwn
铄	jpwx
缒	jpwz
金光	jpxh
金额	jpxw
锤子	jpzw
金子	jpzw
欣	jq
欣	jqan
钦	jqgn
欣喜	jqod
钦佩	jqrj
欣赏	jqxt
给	jr
绅	jrat
绲	jrbb
锟	jrbb
纶	jrbt
铃	jrdd
锉刀	jrdg
锡	jrdp
钤	jrdw
锝	jred
纵队	jrer
绘	jres
绘制	jrfh
给以	jrgd
钽	jrhg
缏	jrhi
给	jrhk
铪	jrhk
臾	jrhn
镎	jrho
缇	jrhr
绘画	jrht
红领巾	jrja
绘图	jrkw
帽	jrma
纵横	jrmc
锞	jrmg
钾	jrog
绅士	jroh
纵身	jrop
纵向	jrpk
综合利用	jrpu
铧	jrqo
纵	jrrt
锉	jrrt
幔	jrsy
缦	jrsy
镘	jrsy
锂	jrtg
钾肥	jrub
缑	jrwd
给予	jrwd
铨	jrwg
纵然	jrxd
幌	jrxe
纵情	jrxh
纵容	jrxr
幌子	jrzw
帽子	jrzw
铸	js
锲	jsad
经济管理	jsaw
经济基础	jsco
镯	jsdv
经济效益	jseb
铸造	jsfa
铴	jsgp
缳	jshi
铸铁	jsjf
铸钢	jsjk
铸型	jskd
绐	jskt
绑架	jslk
经济核算	jsma
经济特区	jsnh
锣鼓	jsod
铸	jspc
帱	jspc
绑	jspe
铸件	jsrn
锣	jsxg
细	jt
舅父	jtbi
绫	jtbw
细节	jtcg
细菌	jtck
钍	jtgh
钿	jtgh
细致	jths
镙	jtjg
缧	jtjt
细纱	jtjx
舅	jtlh
编者按	jtox
铑	jtpb
铐	jtpg
绪	jtpr
锗	jtpr
细微	jtpr
细	jtth
细胞	jtud
细雨	jtuh
细长	jtvp
细心	jtxd
锶	jtxg
细小	jtxg
缌	jtxt
绷带	juca
钥	jugh
镥	jurg
钥匙	jurh
镭	jutg
绷	juut
链	jv
帐	jvan
帐篷	jvaw
镢	jvbq
缛	jvec
铖	jvgd
缄	jvhd
辔	jvjk
缄默	jvkb
编辑部	jvlk
链轮	jvvr
链球	jvwh
链条	jvwh
链	jvzg
链子	jvzw
经	jw
终止	jwaa
终点	jwah
绺	jwak
镅	jwam
绌	jwao
终归	jwap
经受	jwat
锋芒	jwce
绿荫	jwce
绿茶	jwcr
经营	jwct
经过	jwcz
经学	jwdb
绿色	jwdb
终	jwdd
镫	jwdd
经	jwdg
纾	jwdg
钰	jwdg
绿豆	jwdh
改良	jwdi
改变	jwea
经商	jweb
终于	jweg
绿	jwen
改进	jwep
改动	jwes
缝隙	jwex
改选	jwfa
改造	jwfa
终年	jwfh
终生	jwft
钌	jwgg
改革	jwgh
改	jwgn
经费	jwgp
绛	jwha
改正	jwha
纹丝不动	jwhe
己	jwhg
缗	jwhr
改建	jwie
改编	jwjd
纽约	jwjd
经纬	jwjh
改组	jwjk
终结	jwjo
经销	jwjx
改口	jwka
经典	jwkc
铬	jwkg
经由	jwko
绿叶	jwko
缘由	jwko
络	jwkt
改装	jwla
终端	jwlo
缪	jwlp
绿林	jwmm
经验	jwmr
改换	jwod
缘故	jwok
终身	jwop
锋利	jwpm
经委	jwpm
改行	jwpr
终日	jwra
缝合	jwrh
绿化	jwrq
锋	jwsa
糸	jwsg
经济	jwsw
缝	jwsz
绿地	jwtg
改写	jwth
纹	jwtn
钮	jwtt
纽	jwtt
绿肥	jwub
经历	jwvl
终了	jwwg
缫	jwwm
缘	jwwn
经理	jwwr
纟	jwwt
缁	jwwt
锱	jwwt
终究	jwxp
经常	jwxt
改善	jwyb
销	jx
销售	jxak
锁	jxbg
铊	jxbg
缩聚	jxey
缩短	jxfd
忌	jxgd
镓	jxhn
锭	jxhr
绽	jxhr
铛	jxig
缤纷	jxjb
纱线	jxje
销毁	jxjg
镩	jxka
销路	jxka
铭	jxkg
绱	jxkk
缩减	jxlv
综述	jxmd
铵	jxng
镖	jxog
纱布	jxoj
综	jxot
缥	jxot
缤	jxpb
钞	jxpg
纱	jxpt
缩	jxrb
综合	jxrh
镡	jxro
缩写	jxth
镗	jxtt
销	jxug
绡	jxut
纱厂	jxvh
绾	jxwh
缩小	jxxg
锁定	jxxh
镲	jxxo
钞票	jxxo
锭子	jxzw
凤	jy
缮	jybk
钗	jydg
绎	jyea
铎	jyea
凤	jygd
凤凰	jyjb
风言风语	jyjy
殳	jywn
缀	jyyy
近	jz
近	jzan
近世	jzch
近郊	jzeb
近旁	jzeb
近年	jzfh
近来	jzhb
近况	jzlk
锰	jzmg
近视	jzok
近乎	jzpb
近日	jzra
近似	jzrg
近代	jzrh
可	k
路	ka
跑步	kaaa
中坚	kaaa
中频	kaaa
中止	kaaa
噗	kaad
蹊	kaad
蹼	kaad
趾	kaah
蹲点	kaah
路上	kaah
中点	kaah
中上	kaah
忠贞	kaah
蹈	kaaj
踩	kaam
踔	kaao
中非	kaas
中等	kaat
中肯	kaau
蹲	kabc
踯	kabe
贵贱	kabe
趴	kabh
呲	kabh
跟前	kabh
跑道	kabh
口粮	kabm
中断	kabm
嘴	kabo
跸	kabo
蹭	kabr
中美	kabw
嘴巴	kabw
躏	kaca
蹒	kach
中共	kach
中药	kacj
蹀	kacm
躇	kacr
跌落	kacs
中期	kacs
遗著	kact
跨过	kacz
路过	kacz
中学	kadb
蹁	kadc
趵	kadd
跟头	kadd
口头	kadd
跪	kadg
跨	kadg
卟	kadh
足够	kadk
踉	kadn
贵州	kadp
中旬	kadr
跑	kads
同等学历	kadv
践	kaed
蹴	kaed
跳远	kaee
忠于	kaeg
跤	kaei
距离	kaei
蹄	kaej
跳高	kaek
跟随	kaeo
遗迹	kaep
跃进	kaep
踪迹	kaep
足迹	kaep
趺	kaer
贵阳	kaer
中队	kaer
跳动	kaes
遗弃	kaes
遗忘	kaew
中专	kaew
贵院	kaex
蹑	kaey
中选	kafa
躜	kafb
跳舞	kafc
跌	kafd
遗失	kafd
跣	kafe
贵族	kaff
中年	kafh
踟	kafk
中午	kafo
冂	kag
跨度	kagc
足以	kagd
中庸	kagi
唯恐	kagj
踮	kagk
路费	kagp
躔	kagt
跛	kagy
踱	kagy
中	kah
足下	kaha
贵	kahb
咔	kahd
跷	kahe
中医	kahf
口才	kahg
噬	kahh
唯	kahh
嘘	kahh
噍	kahh
唯一	kahh
唬	kahj
由此可见	kahk
噱	kahn
路面	kahp
足	kahr
中毒	kaht
距	kahw
中东	kahw
躞	kahy
遣	kahz
遗	kahz
跟	kain
踺	kaiz
路线	kaje
中线	kaje
跺	kajm
中级	kajp
跽	kajx
踌躇	kaka
跟踪	kaka
践踏	kaka
路口	kaka
跳跃	kaka
踊跃	kaka
中路	kaka
踉跄	kaka
蹉跎	kaka
蹂躏	kaka
蹒跚	kaka
口吻	kakd
中型	kakd
中央	kakd
口味	kake
趼	kakh
口号	kakh
躁	kakm
遗嘱	kako
中叶	kako
贵国	kakw
跨国	kakw
中国	kakw
贵站	kala
中将	kala
中立	kald
跏	kalk
踣	kalk
中部	kalk
遗产	kalp
口音	kalr
跨栏	kamb
口述	kamd
贵校	kame
盅	kamh
中枢	kamh
路标	kamo
踏板	kamp
跳板	kamp
中间	kamr
跳马	kamw
唯物	kand
遗物	kand
贵姓	kanf
踹	kaoa
中山	kaoa
中指	kaob
跋	kaod
中层	kaoe
贵局	kaog
跖	kaoh
遗志	kaoh
踞	kaok
蹦	kaou
唯有	kaou
口岸	kaov
中段	kapa
踬	kapb
跃	kapd
踽	kapd
中看	kape
遗留	kapg
跚	kaph
贵重	kaph
跳	kapl
路程	kapm
中和	kapm
趿	kapn
贵所	kapp
口径	kapr
路径	kapr
踵	kapt
蹯	kapt
跞	kapx
跹	kapz
口气	kaqp
唯独	kaqv
啮	kara
中日	kara
跳伞	karb
跗	karc
口供	karc
路途	kare
遗传	kare
中途	kare
踪影	kare
跄	karg
口袋	karh
啮合	karh
蹋	karl
踝	karm
遗体	karm
踢	karp
中介	karp
中华	karq
跌价	karr
跋涉	kasa
中耕	kasa
踌	kasc
嚼	kasc
中流	kase
中游	kasf
口水	kasg
跳水	kasg
中波	kasg
跆	kask
遗漏	kaso
踏	kasr
啡	kass
躅	kasv
遗址	kata
中农	kati
跬	katt
嗳	katy
中用	kaua
啃	kauh
口腔	kaux
中原	kavb
蹰	kavc
中转	kave
嘴唇	kave
贵厂	kavh
蹶	kavq
跻	kawa
蹬	kawd
中文	kawd
躐	kawg
口	kawh
囗	kawh
足球	kawh
路	kawk
蹂	kawm
鹭	kawn
踊	kawo
中外	kaxa
跎	kaxb
踏实	kaxd
唯心	kaxd
中心	kaxd
忠实	kaxd
忠心	kaxd
中性	kaxf
中小	kaxg
忠	kaxh
蹿	kaxk
踪	kaxo
贵宾	kaxp
贵省	kaxp
中常	kaxt
遗憾	kaxv
蹉	kayg
口语	kayh
跟着	kaym
忠诚	kayv
跨越	kazh
只	kb
吖	kbah
墨笔	kbam
只管	kbax
喈	kbbb
吡	kbbh
嘤	kbbn
哔	kbbo
黑白	kbbp
黑幕	kbcr
黑色	kbdb
吩	kbdh
圈套	kbdh
黩武	kbea
圈	kbeh
郧	kbeh
只限	kbei
黑市	kbej
黑夜	kber
员工	kbgh
员	kbhd
只	kbhd
呗	kbhd
黩	kbhd
吧	kbhg
邑	kbhg
黑	kbhh
黠	kbhk
黝	kbhl
嗌	kbhm
叭	kbhn
黜	kbho
黪	kbhp
默	kbhq
黯	kbhr
墨	kbht
嗍	kbhu
黔	kbhw
罔	kbhw
黢	kbhw
黟	kbhx
黥	kbhx
嗲	kbix
墨绿	kbjw
默默	kbkb
呖呖	kbkb
黝黑	kbkb
只见	kbkp
噌	kbkr
吩咐	kbkr
勋	kblh
呖	kblh
勋章	kblr
咪	kbmh
嗥	kbmh
喽	kbmn
黑板	kbmp
只好	kbnz
只有	kbou
啤	kbpo
只得	kbpr
唣	kbqh
只是	kbrh
黑暗	kbrl
黑人	kbrp
墨水	kbsg
墨汁	kbso
啤酒	kbsy
只顾	kbvg
只怕	kbxb
默然	kbxd
黯然	kbxd
黑光	kbxh
只要	kbxn
默许	kbyf
默认	kbyr
圈子	kbzw
曲	kc
同甘共苦	kccc
典范	kccs
嚆	kcek
呓	kcgh
典	kchb
哄	kchb
曲式	kchg
喋	kchm
曲面	kchp
曲	kchw
典雅	kchw
哎	kcih
曲线	kcje
典型	kckd
唠叨	kckd
哎呀	kckh
嘶哑	kckh
哎哟	kckj
中共中央	kckk
口若悬河	kcks
曲柄	kcmh
典礼	kcog
内蒙古自治区	kcoh
曲折	kcoj
喏	kcok
典故	kcok
嗬	kcrg
嗒	kcrk
噶	kcrw
嘶	kcsj
喵	kcth
唠	kctl
曲轴	kcvk
曲调	kcyp
曲子	kczw
因	kd
因此	kdab
刑	kdag
因数	kdbm
恩赐	kdbr
嘹	kdbx
呔	kddh
因为	kddl
嘹亮	kdek
啕	kdfh
中学生	kdft
咏	kdgn
央求	kdhg
刑事	kdhk
叨	kdhp
因而	kdhp
因素	kdht
因	kdhw
恩	kdhx
啷	kdie
唤	kdkd
型号	kdkh
咆哮	kdkt
劭	kdlp
盎	kdmw
鸯	kdnw
因故	kdok
唳	kdoq
囫	kdph
吻	kdpp
唿	kdpx
听之任之	kdrd
吻合	kdrh
因果	kdrm
恩人	kdrp
咆	kdsh
刑法	kdst
刑罚	kdsy
型	kdta
刑场	kdtg
噜	kdtr
喹	kdtt
见义勇为	kdwd
央	kdwn
盎然	kdxd
恩情	kdxh
贵州省	kdxp
唤醒	kdyr
哒	kdzh
因子	kdzw
啊	ke
邢	keaa
味	keab
兄弟	kebg
味道	kebh
咬	kebi
啼	kebj
嘀	kebk
味精	kebm
园艺	kecg
国防大学	kedd
国际主义	keed
园	keeh
贵阳市	keej
戢	kegd
吁	kegh
叩	keha
啊	kehg
兄	kehg
园丁	kehg
咬牙	kehw
吭	kejh
哼	kekg
咳嗽	kekh
嚷	keki
国防部	kelk
园林	kemm
兄妹	kene
鹗	keng
吭声	keoh
呒	kepg
国防科工委	kepp
吴	kerh
呋	kerh
啐	kero
唷	kesu
园地	ketg
咳	kewr
嗫	keyy
吃	kf
吃紧	kfaa
咋	kfae
吃苦	kfco
吃亏	kfeg
嗾	kffd
吃	kfgh
吃喝	kfkr
吃力	kflg
吃饭	kfop
吃香	kfpm
吃水	kfsg
吃惊	kfxe
叫	kg
哪些	kgab
叫	kgah
吲	kgah
国庆节	kgcg
叫苦	kgco
哪	kgee
哪儿	kgep
叫唤	kgkd
叫嚷	kgke
叫嚣	kgkk
叫喊	kgkv
嘞	kglh
嘛	kgmm
哪样	kgmy
哪个	kgra
叫做	kgro
哪里	kgrt
哪能	kgsu
叼	kgth
哪怕	kgxb
同	kh
开业	khaa
开凿	khaa
同步	khaa
吓	khad
形而上学	khad
哑	khah
圄	khah
同上	khah
唔	khak
开采	kham
开盘	kham
同等	khat
哺乳	khaz
开关	khbe
同类	khbm
哺养	khbs
开荒	khce
开花	khcr
开幕	khcr
同期	khcs
开学	khdb
同学	khdb
开头	khdd
开刀	khdg
开朗	khdi
号召	khdk
开户	khdo
开启	khdo
形式主义	khed
开除	kher
哺育	khes
开动	khes
团聚	khey
团旗	khff
同年	khfh
另一方面	khfh
开放	khfw
哓	khge
叮	khgh
号	khgh
团	khgh
开工	khgh
饕	khgo
开庭	khgp
咦	khgr
开张	khgv
围攻	khgw
开平	khhb
开火	khhd
围	khhh
啖	khhh
同一	khhh
同事	khhk
开	khhp
围歼	khhx
开垦	khig
围裙	khii
呕	khiw
围巾	khja
围绕	khjh
团结	khjo
咂	khjw
开销	khjx
嗝	khka
开口	khka
开路	khka
吓唬	khka
喇叭	khkb
团员	khkb
喇	khkd
璺	khkd
呵	khkg
同	khkg
爨	khkh
囔	khki
团圆	khkk
哽咽	khkk
围困	khkm
叮嘱	khko
嗽	khkq
嘈	khkr
呕吐	khkt
开国	khkw
叮咛	khkx
开办	khlb
团部	khlk
开端	khlo
同意	khlr
围棋	khmc
开门	khmd
开眼	khmi
开枪	khmr
开阔	khms
同样	khmy
开始	khns
开展	khoc
开局	khog
开矿	khog
同志	khoh
开辟	khok
号码	khom
开拓	khoo
开饭	khop
开支	khoy
嘎	khpg
号称	khpm
啄	khpn
同行	khpr
嗄	khpw
刑事犯罪	khqs
同伴	khrb
同时	khrc
号令	khrd
开会	khre
开创	khrg
呸	khrh
哽	khri
团体	khrm
默不作声	khro
同人	khrp
开化	khrq
同化	khrq
同盟	khru
开明	khru
开水	khsg
开春	khsr
开罗	khsx
啧	khtb
圊	khth
嗉	khtj
围墙	khto
开封	khtt
唛	khtw
嗷	khtw
哺	khud
同胞	khud
圃	khuh
开车	khvh
团长	khvp
开通	khwd
同班	khwd
吨	khwg
囤	khwh
呀	khwp
开发	khwp
哐	khww
同乡	khww
咧	khxd
开心	khxd
同心	khxd
同情	khxh
叮当	khxi
开设	khyj
号子	khzw
史	ki
啸	kiab
网点	kiah
史料	kibm
史学	kidb
刚	kidg
刚度	kigc
冈	kigd
唧	kige
刚强	kigk
哏	kign
刚才	kihg
史	kihn
网	kiig
网络	kijw
刚刚	kiki
唧唧	kiki
刚毅	kilp
刚好	kinz
唏	kioj
刚果	kirm
刚体	kirm
史书	kiwg
网球	kiwh
史实	kixd
刚性	kixf
听	kj
听筒	kjak
嗖	kjay
听觉	kjdb
哟	kjdd
听取	kjey
吊	kjha
听	kjha
叽	kjhg
吊钩	kjjd
听风	kjji
听见	kjkp
吊唁	kjky
吊装	kjla
中组部	kjlk
吊杆	kjme
哚	kjmh
吊索	kjot
中纪委	kjpm
听从	kjrr
听众	kjrr
听信	kjry
听说	kjyb
听讲	kjye
听话	kjyp
听诊	kjyr
串	kkah
圆筒	kkak
回采	kkam
圆盘	kkam
回归	kkap
回答	kkar
患	kkax
嘿	kkbh
圆	kkbh
回敬	kkcd
嗣	kkck
中国共产党	kkcx
回头	kkdd
咽	kkdh
嗯	kkdx
颚	kkeb
串联	kkeb
鄂	kkee
默默无闻	kkem
回击	kkeo
圆规	kker
回旋	kkff
回族	kkff
回复	kkfr
回收	kkga
圆弧	kkgp
嚣张	kkgv
回来	kkhb
回火	kkhd
中国青年	kkhf
中国政府	kkhg
吕	kkhh
嚣	kkhk
中央政治局委员	kkhk
中央政治局	kkho
中央政治局常委	kkhp
回	kkhw
圆锥	kkja
咒	kkjh
品级	kkjp
中国银行	kkjp
回路	kkka
咀嚼	kkka
圆圈	kkkb
回味	kkke
品	kkkh
咒骂	kkkk
叽叽喳喳	kkkk
噪	kkkm
回响	kkkp
圆形	kkkp
咽喉	kkkr
器具	kkks
呐喊	kkkv
回音	kklr
噪音	kklr
中央办公厅	kklv
器皿	kkma
骂	kkmh
器材	kkmh
器械	kkmh
回想	kkmm
回声	kkoh
噪声	kkoh
回避	kkok
中国科学院	kkpe
圆周	kkpg
中央委员	kkpk
品种	kkpm
品质	kkpp
品德	kkpr
品行	kkpr
中央委员会	kkpr
哭	kkqh
器	kkqk
剐	kkrd
回电	kkrg
呐	kkrh
呙	kkrh
回合	kkrh
品位	kkrl
器件	kkrn
中国人民银行	kkrp
中央全会	kkrr
中央电视台	kkrs
中央人民广播电台	kkrs
中国人民解放军	kkrt
中国人民	kkrw
回信	kkry
圆满	kksc
咀	kksh
哭泣	kksl
鼍	kktg
患者	kktp
中央军委	kktp
回去	kkts
回转	kkve
回顾	kkvg
串通	kkwd
回民	kkwh
中央各部委	kkwp
回乡	kkww
中央书记处	kkww
圆心	kkxd
回忆	kkxg
回家	kkxh
器官	kkxw
踏踏实实	kkxx
迥	kkzg
另	kl
别管	klax
别	kldh
别离	klei
另	klhp
叻	klhp
别致	klhs
咖啡	klka
咖	klkh
别国	klkw
唼	klnh
别扭	klow
别看	klpe
别称	klpm
另行	klpr
喑	klrh
别人	klrp
别墅	klrt
噫	klrx
别处	klwa
内部矛盾	klwp
另外	klxa
别名	klxk
别字	klxz
别说	klyb
吗	km
困苦	kmco
吗	kmhh
困惑	kmhk
呆	kmhn
困	kmhw
喳喳	kmkm
啉	kmmh
噤	kmmo
喳	kmrh
呆滞	kmsc
困境	kmtl
困难	kmya
跑马观花	kmyc
鸣	kn
唯物主义	kned
鸣放	knfw
鸣	knhh
囡	knhw
呶	knyh
由	ko
由此	koab
嘲笑	koap
喷管	koax
邮购	kobd
邮递	kobg
呢	kobh
啪	kobh
喃	kobo
喷泉	kobs
喷	kocb
固态	kodd
嘻	kodk
嘭	kodp
邮包	kods
由于	koeg
别有天地	koet
咙	kogd
叶鞘	kogx
喘	koha
叶	koha
邮政	koha
由来	kohb
噎	kohd
邮	kohe
鄙夷	kohg
咴	kohh
咭	kohk
叶面	kohp
喔	koht
胄	kohu
由	kohw
迪	kohz
唰	kojd
哳	kojh
喷嘴	koka
鄙	koke
咕	kokh
固	kokh
噼	koko
喃喃	koko
嘱咐	kokr
啦	kolh
团支部	kolk
叶柄	komh
喷射	kooc
邮局	koog
鄙视	kook
固执	koop
嘱托	koop
固有	koou
叶片	kopa
嘱	kopd
喘息	kopm
因势利导	kops
喘气	koqp
喷气	koqp
邮电	korg
固体	korm
同志们	korm
鄙人	korp
固化	korq
嘲	koru
嗔	kosb
喷灌	kosc
黑龙江	kosg
喷漆	kosm
喷洒	kosx
黑龙江省	kosx
嗦	kotj
嚏	kotr
囿	kouh
嘣	kouu
喷雾	kouw
叶轮	kovr
嘲弄	kowc
固守	koxc
固然	koxd
邮寄	koxd
哕	koxh
固定	koxh
邮票	koxo
嗔怪	koxy
吱	koyh
嘲讽	koyj
叶子	kozw
见	kp
呼	kpbg
见鬼	kpbp
嗅觉	kpdb
形态	kpdd
形象	kpdk
见解	kpdu
形变	kpea
见效	kpeb
响亮	kpek
形迹	kpep
吸附	kper
吸取	kpey
吸收	kpga
吸引	kpga
呼应	kpgd
响应	kpgd
呜	kpgh
啁	kpgk
见	kpgw
形式	kphg
吸烟	kphk
见面	kphp
噢	kpkd
呼唤	kpkd
呼吁	kpke
呼啸	kpki
响	kpkk
呼吸	kpkp
呼喊	kpkv
形状	kpla
见闻	kpme
咱	kpmh
啾	kpmh
嗅	kpmq
哦	kpod
唾	kpoh
呼声	kpoh
响声	kpoh
吸热	kpop
形势	kpop
呱	kppn
哌	kppn
形	kppp
吒	kpqh
吸气	kpqp
咱俩	kprh
形体	kprm
咱们	kprm
唾液	kpse
哈尔滨市	kpse
呼和浩特市	kpse
唾沫	kpsh
呼和浩特	kpsn
吸湿	kpsr
哈尔滨	kpsx
形成	kpvg
另行通知	kpwf
吸	kpwn
见外	kpxa
另行安排	kpxo
形容	kpxr
见证	kpyh
见识	kpyk
吹动	kqes
吠	kqhd
叱	kqhg
吹	kqhn
吹风	kqji
吹嘘	kqka
叱咤	kqkx
吹拂	kqog
吹捧	kqos
吹牛	kqow
吹奏	kqsr
内	kr
呻	krah
呷	krah
内战	krah
喝彩	kram
囵	krbh
肉类	krbm
咐	krch
内幕	krcr
呤	krdd
喉头	krdd
囹	krde
内角	krdu
喝	krdw
吟	krdw
内陆	kree
啥	krek
内阻	krek
哙	kres
噙	kres
嘬	krey
内	krgd
内应	krgd
呛	krgg
黾	krgh
内疚	krgl
内政	krha
喻	krhd
哈	krhk
唱歌	krhk
因人而异	krhs
囚	krhw
咿	krih
内线	krje
内销	krjx
喁	krkd
内因	krkd
嚎	krkn
喉咙	krko
哈哈	krkr
呻吟	krkr
内力	krlg
内部	krlk
邮电部	krlk
咻	krmh
肉眼	krmi
囚禁	krmm
内阁	krmw
内存	kroa
内在	kroa
肉食	krop
唱段	krpa
唱片	krpa
肉片	krpa
内科	krpm
内行	krpr
哗	krqo
肉	krrg
唱	krrh
中华人民共和国	krrk
肉体	krrm
唑	krrt
内参	krsd
内河	krsh
内能	krsu
喝酒	krsy
内地	krtg
哩	krth
具体地说	krty
内脏	krug
唱腔	krux
喉	krwd
中华民族	krwf
内外	krxa
口是心非	krxa
内心	krxd
内容	krxr
唱词	kryg
唱戏	kryg
具体说来	kryh
唆	ksbw
开源节流	kscs
唉	ksfd
嗨	ksfm
啵	ksgy
具	kshb
圜	kshh
悬殊	kshx
助跑	kska
助	kslw
哞	ksnh
悬臂	ksok
助手	ksop
悬挂	ksot
具有	ksou
悬崖	ksov
县委	kspm
悬垂	kspo
嗪	ksrm
具体	ksrm
唪	ksro
悬浮	kssa
县	kssw
悬	kssx
助教	kstp
县城	kstv
县长	ksvp
助长	ksvp
且	kswh
助理	kswr
具备	kswt
县官	ksxw
喂	kt
圉	ktbh
喂养	ktbs
因地制宜	ktfx
冉	ktgh
吐	kthh
喂	kthn
哝	ktih
嘟囔	ktkh
嗜好	ktnz
哧	ktpb
嘟	ktpe
嗜	ktpr
哮	ktpz
嗑	ktsm
哇	ktth
喟	ktuh
吐露	ktuk
鹃	ku
嚯	kuah
嚅	kuha
鹃	kunh
虽	kv
嘁	kvad
虽则	kvbd
噘	kvbq
啭	kved
呃	kvgg
喊	kvhd
虽	kvhd
喊叫	kvkg
喱	kvrt
虽然	kvxd
虽说	kvyb
国	kw
国策	kwah
咄	kwao
国籍	kwas
嗤	kwav
国粹	kwbm
国营	kwct
咚	kwdd
噔	kwdd
骨头	kwdd
图	kwde
国	kwdh
图象	kwdk
中文之星	kwdr
图解	kwdu
嗵	kwdz
骨干	kwea
国防	kwef
郢	kweh
国际	kweo
国务院办公厅	kwev
国务院	kwex
国旗	kwff
国庆	kwgd
逞强	kwgk
呈	kwhh
国歌	kwhk
国事	kwhk
国画	kwht
图表	kwht
图画	kwht
逞凶	kwiw
图纸	kwjp
国民经济	kwjs
咯	kwkh
图形	kwkp
骨肉	kwkr
国内	kwkr
吆喝	kwkr
骨骼	kwkw
国立	kwld
骨架	kwlk
国产	kwlp
国标	kwmo
图标	kwmo
图样	kwmy
呈报	kwoe
呈献	kwok
国有	kwou
图书馆	kwox
哜	kwpa
图片	kwpa
国务委员	kwpk
国徽	kwpr
骨气	kwqp
国会	kwre
国人	kwrp
中文电脑	kwru
吆	kwsh
呦	kwsl
国法	kwst
逞能	kwsu
骱	kwta
髌	kwtb
骶	kwtd
髋	kwtg
国土	kwth
骺	kwtk
骼	kwtk
髂	kwtk
国境	kwtl
髁	kwtm
鹘	kwtn
骷	kwto
髀	kwto
骸	kwtr
骨	kwtu
髑	kwtv
骰	kwty
髓	kwtz
呈文	kwwd
图书	kwwg
咝	kwwh
国民	kwwh
国王	kwwh
呈现	kwwk
国务	kwwl
喙	kwwn
国外	kwxa
国家	kwxh
国情	kwxh
图案	kwxn
中文窗	kwxp
国民党	kwxt
国语	kwyh
逞	kwzh
唢	kxbh
嘧	kxdo
唯心主义	kxed
忠心耿耿	kxee
吣	kxhd
咣	kxhe
咛	kxhg
喧	kxhh
哂	kxhh
啶	kxhr
噻	kxht
吵嘴	kxka
吵嚷	kxke
同心同德	kxkp
喧哗	kxkr
吵架	kxlk
中宣部	kxlk
固定资产	kxll
国家机关	kxmb
吵闹	kxme
喧闹	kxme
嘌	kxoh
同心协力	kxol
哨兵	kxpa
国家利益	kxpb
吵	kxph
咤	kxpq
中外合资	kxrl
哨	kxuh
喀	kxwk
哆	kxxh
嚓	kxxo
见多识广	kxyg
叹	ky
嗟	kygh
咩	kyha
唁	kyhh
叹	kyhn
嗓音	kylr
开诚布公	kyob
叹息	kypm
叹气	kyqp
国计民生	kywf
嗓	kyym
啜	kyyy
嗓子	kyzw
吼	kz
吼	kzgh
囝	kzhw
吼叫	kzkg
了	l
将	la
准则	labd
装料	labm
状态	ladd
壮大	ladh
状元	laee
装运	laes
装卸	lafo
将来	lahb
站	lahk
装束	lahk
壮丽	lahk
壮烈	lahx
奖金	lajp
将近	lajz
奖品	lakk
奖状	lala
站立	lald
状况	lalk
奖章	lalr
奖杯	lamh
妆	lant
装扮	laob
壮苗	laoc
准确	laod
装饰	laof
壮	laoh
将士	laoh
壮士	laoh
壮志	laoh
装	laoi
站岗	laok
奖牌	lapa
奖惩	lapr
状	laqt
装甲	lara
装修	lara
准时	larc
将领	lard
站住	lare
浆液	lase
酱油	lask
站台	lask
装置	laso
丬	lat
准	lath
将军	latv
装载	latv
奖励	lavh
站长	lavp
装备	lawt
准备	lawt
将	laxc
奖	laxd
桨	laxm
将要	laxn
浆	laxs
酱	laxy
准许	layf
装订	layh
装配	layj
壮观	layk
办	lb
办公	lbbs
办学	lbdb
凝望	lbeg
凝聚	lbey
凝	lbfr
办事	lbhk
凝结	lbjo
凝固	lbko
凝视	lbok
凝神	lbor
办	lbpd
办法	lbst
办公厅	lbvh
办理	lbwr
办公室	lbxh
办案	lbxn
奖勤罚懒	lcsx
立	ld
立刻	ldew
立方	ldfd
立功	ldgl
立	ldhd
净	ldig
立即	ldig
立足	ldka
新兴产业	ldla
立柱	ldme
立志	ldoh
立体	ldrm
净化	ldrq
立法	ldst
冫	ldt
立场	ldtg
立宪	ldxf
立案	ldxn
凉	le
凉爽	lehi
凛	leko
凉	lekx
凛冽	lelh
新陈代谢	lery
凉水	lesg
新天地	letg
凛然	lexd
冼	lfae
新生事物	lfhn
力	lg
力学	lgdb
力争	lgdi
加以解决	lgdl
力矩	lgfd
力度	lggc
力求	lghg
新疆维吾尔族	lgjf
新疆维吾尔自治区	lgjh
力图	lgkw
翊	lgll
力臂	lgok
力	lgp
力气	lgqp
力量	lgrh
力偶	lgrr
新	lh
亲临	lhaa
亲笔	lham
亲爱	lhat
新颖	lhbp
新兴	lhdb
新奇	lhdh
新郎	lhdi
新房	lhdo
新年	lhfh
亲生	lhft
新生	lhft
冻疮	lhgl
新疆	lhgt
新政	lhha
新式	lhhg
冻死	lhhx
新建	lhie
凄	lhin
冻结	lhjo
亲缘	lhjw
亲近	lhjz
新近	lhjz
竦	lhkb
办事员	lhkb
新型	lhkd
凄凉	lhle
新闻	lhme
亲眼	lhmi
新娘	lhnd
亲热	lhop
亲身	lhop
亲手	lhop
亲属	lhop
新手	lhop
亲友	lhoy
新兵	lhpa
亲自	lhpm
亲切	lhqd
亲昵	lhro
亲人	lhrp
新人	lhrp
亲信	lhry
靖	lhtu
新鲜	lhuy
亲戚	lhva
办事处	lhwa
冱	lhwh
亲王	lhwh
新民	lhwh
冻	lhwx
冽	lhxd
亲密	lhxd
亲	lhxh
新	lhxj
凄惨	lhxs
飒	ljit
边缘科学	ljpd
部	lk
加紧	lkaa
冲	lkat
部分	lkbd
部类	lkbm
加料	lkbm
加数	lkbm
贺	lkbp
加盖	lkbw
部落	lkcs
剖	lkdh
加大	lkdh
加急	lkdi
竞争	lkdi
部	lkeh
竞	lkeh
冲击	lkeo
部队	lker
冲天	lker
冲动	lkes
况	lket
竞选	lkfa
加以	lkgd
加工	lkgh
加强	lkgk
部下	lkha
瓿	lkhd
哿	lkhg
冲刺	lkhj
加速	lkhk
剖面	lkhp
袈	lkip
加纳	lkjk
加固	lkko
况且	lkks
加力	lklg
部门	lkmd
剖析	lkmj
驾驶	lkmk
架	lkmp
驾	lkmp
冲破	lkog
冲刷	lkoj
冲撞	lkol
加剧	lkoo
加热	lkop
加	lkph
加重	lkph
部委	lkpm
冲程	lkpm
冲积	lkpm
加入	lkpn
加氢	lkqw
加仑	lkrb
部位	lkrl
加倍	lkrl
部件	lkrn
冲洗	lksf
加油	lksk
部署	lkst
加法	lkst
加深	lkst
加载	lktv
部长	lkvp
加厚	lkvr
冲压	lkvt
加压	lkvt
加班	lkwd
加密	lkxd
竞赛	lkxh
冲突	lkxq
加快	lkxw
架设	lkyj
架	lkz
迦	lkzp
架子	lkzw
辛辛苦苦	llcc
资产阶级	llej
勰	lllx
冯	lm
凇	lmbs
资本主义	lmed
冯	lmth
新闻记者	lmyt
妾	lnhh
端	lo
辛勤	loch
辛苦	loco
辛劳	loct
辨	lodo
辩解	lodu
准确无误	loey
端庄	logt
端	loha
辛	loha
端正	loha
辣	lohb
辫	lojo
辨别	lokl
辣椒	loma
新技术	lomd
辩驳	lomi
新技术革命	lomr
辩护	lood
瓣	lopo
竭尽全力	lorl
辨证	loyh
辩证	loyh
辨识	loyk
辩	loyo
辨认	loyr
辩论	loyr
端详	loyy
辫子	lozw
产	lp
产业	lpaa
颜料	lpbm
颜色	lpdb
产生	lpft
凋	lpgk
毅	lpgy
产	lph
颜面	lphp
产销	lpjx
产品	lpkk
毅力	lplg
产权	lpmy
产物	lpnd
产妇	lpni
颜	lppb
产卵	lppg
彦	lppp
产量	lprh
产值	lpro
力所能及	lpsp
产地	lptg
毅然	lpxd
凋谢	lpyo
盗贼	lqbh
粢	lqbm
次数	lqbm
资料	lqbm
资	lqbt
姿态	lqdd
次序	lqgw
瓷	lqhd
资金	lqjp
瓷器	lqkk
次品	lqkk
资助	lqks
咨	lqkt
资产	lqlp
资本	lqmh
盗	lqmt
资格	lqmw
姿	lqnt
姿势	lqop
次日	lqra
资源	lqsv
次	lqtn
盗用	lqua
资历	lqvl
次要	lqxn
盗窃	lqxq
恣	lqxt
咨询	lqyd
意	lr
音频	lraa
冷笑	lrap
音符	lrar
意料	lrbm
冷落	lrcs
音色	lrdb
冷	lrdd
意义	lrdi
韶	lrdk
韵	lrdl
竭	lrdw
竟	lreh
音高	lrek
音阶	lrer
童年	lrfh
音	lrhh
冷静	lrht
意味	lrke
意见	lrkp
音响	lrkp
意图	lrkw
音准	lrla
冷凝	lrlb
竭力	lrlg
冷冻	lrlh
韵母	lrmw
赣	lrob
鄣	lroe
章	lroh
意志	lroh
彰	lrop
新华社	lrot
戆	lrox
音程	lrpm
章程	lrpm
音质	lrpp
音乐	lrpw
歆	lrqh
冷气	lrqp
意气	lrqp
音量	lrrh
音位	lrrl
音信	lrry
冷汗	lrse
冷水	lrsg
冷淡	lrsh
冷清	lrsh
童	lrth
音域	lrth
意境	lrtl
冷却	lrts
意思	lrtx
意愿	lrvb
冷轧	lrvg
竟敢	lrwe
新华书店	lrwg
新华通讯社	lrwo
意外	lrxa
竟然	lrxd
意	lrxh
冷酷	lryf
意识	lryk
童话	lryp
音调	lryp
冰	ls
冰箱	lsam
冰糖	lsbm
凑数	lsbm
竣	lsbw
凑巧	lsgh
竣工	lsgh
冰鞋	lsgt
冶炼	lshh
冶金	lsjp
冶	lskt
冰凉	lsle
冰冻	lslh
冰冷	lslr
冰棒	lsms
冰山	lsoa
冰川	lspa
凑	lsrd
凑合	lsrh
冰	lstn
冰雹	lsud
冰雪	lsui
冰球	lswh
凌	lt
凌	ltbw
凌乱	ltpo
凌晨	ltrv
减	lv
减弱	lvgl
减	lvhd
减产	lvlp
减低	lvrp
减法	lvst
减压	lvvt
减轻	lvvw
减小	lvxg
减少	lvxp
减慢	lvxr
决	lw
决策	lwah
决战	lwah
决算	lwam
决断	lwbm
决	lwdt
决不	lwhr
决裂	lwhx
决口	lwka
决心	lwxd
决定	lwxh
决赛	lwxh
决议	lwyd
亲密无间	lxem
将计就计	lyey
意识形态	lykd
辩证法	lyst
边	lz
边远	lzee
边防	lzef
边际	lzeo
边陲	lzep
边疆	lzgt
边区	lzhi
边线	lzje
边锋	lzjw
边缘	lzjw
边	lzpn
边沿	lzsj
边境	lztl
边界	lztr
没	m
目	ma
榄	maag
标点符号	maak
槛	maam
目的	mabd
眦	mabh
目前	mabh
朴	madd
椎	madh
骥	maeb
桢	mahb
樵	mahd
瞧	mahh
睢	mahh
雎	mahh
梧	mahk
毡	mahk
栌	maho
棹	maho
朴素	maht
椒	mahy
林业部	malk
睬	mamh
目标	mamo
瞬间	mamr
目睹	mamt
榫	maod
瞬	mata
骓	math
阌	maty
皿	mawa
目录	mawe
目	mawh
朴实	maxd
目光	maxh
阅览室	maxh
骑虎难下	mayh
桴	mazd
松	mb
阅览	mbaa
楷	mbbb
枇	mbbd
棉籽	mbbm
樱	mbbn
松散	mbch
棉花	mbcr
樱花	mbcr
杷	mbdg
柏	mbdh
盼	mbdh
相比之下	mbdh
槔	mbdo
楼房	mbdo
盼望	mbeg
松动	mbes
檄	mbfw
梯	mbgp
睇	mbgp
楼下	mbha
阙	mbhq
氆	mbhr
棉衣	mbid
棉袄	mbip
棉	mbjd
棉纺	mbjf
棉纱	mbjx
阅	mbke
松开	mbkh
梯形	mbkp
骈	mbkt
瞵	mbma
楼梯	mbmb
阐述	mbmd
栏杆	mbme
松驰	mbmg
柏木	mbmh
柏林	mbmm
松林	mbmm
楼	mbmn
楼板	mbmp
楼阁	mbmw
槐树	mbmy
松树	mbmy
棉布	mboj
松香	mbpm
睥	mbpo
槐	mbps
闭关自守	mbpx
阐	mbro
阐明	mbru
栏	mbsd
松	mbsd
柏油	mbsk
棉田	mbta
梯田	mbta
目的地	mbtg
松土	mbth
阅历	mbvl
松软	mbvq
松懈	mbxu
樽	mbyc
阅读	mbyo
梯子	mbzw
村	mc
棋盘	mcam
模糊	mcbm
模数	mcbm
村落	mccs
模范	mccs
村	mcdd
柑	mced
栉	mcga
村庄	mcgt
横	mchb
模式	mchg
瞒	mchr
槿	mcht
横线	mcje
本世纪	mcjj
村镇	mcjo
模型	mckd
模具	mcks
瞄准	mcla
模板	mcmp
模样	mcmy
模拟	mcog
横向	mcpk
横行	mcpr
模	mcrd
模仿	mcrf
棋	mcsb
骐	mcsb
横梁	mcsd
椹	mcsw
瞄	mcth
檬	mctn
模块	mctw
横轴	mcvk
村长	mcvp
模压	mcvt
村子	mczw
棋子	mczw
门	md
门	mdag
构筑	mdag
门第	mdag
榉	mdbo
檐	mdby
杓	mddd
门房	mddo
门户	mddo
门市	mdej
杭州市	mdej
构造	mdfa
门生	mdft
橡皮	mdgp
骑	mdhg
椅	mdhg
阆	mdid
榔	mdie
睁	mdig
驺	mdit
阎	mdjg
门口	mdka
门路	mdka
枸	mdkd
橡	mdkn
驹	mdkt
构图	mdkw
门槛	mdma
门楼	mdmb
桅杆	mdme
门框	mdmh
门板	mdmp
门阀	mdmr
骑马	mdmw
术	mdn
骗	mdoc
骗局	mdog
骟	mdol
驴	mdot
骑兵	mdpa
阉	mdrg
阄	mdrg
构件	mdrn
门人	mdrp
骗人	mdrp
瞻仰	mdrp
构	mdsd
驮	mdtn
构思	mdtx
桷	mdua
橡胶	mdue
槲	mduo
桅	mdvg
构成	mdvg
瞻	mdvy
术语	mdyh
门诊	mdyr
述	mdzd
闼	mdzg
骗子	mdzw
椅子	mdzw
校	me
杆	mead
核算	meam
榜	mebf
校	mebi
杆菌	meck
杭州	medp
椰	meed
闹市	meej
毛主席	megc
栈	megd
阋	megg
闻	megh
盱	megh
校正	meha
闹事	mehk
杭	mejd
柿	mejd
闹	mejg
闶	mejg
校园	meke
檀	mekh
骧	meki
榱	meki
槁	mekk
椭圆	mekk
檩	meko
椋	mekx
椁	mekz
核准	mela
核桃	memp
榜样	memy
驻扎	meog
椭	meou
校舍	mere
梳	mesg
柱	metd
驻地	metg
驻	mett
驻军	metv
校长	mevp
骇	mewr
核	mewr
阂	mewr
梳理	mewr
眩	mews
校外	mexa
驻守	mexc
核实	mexd
核心	mexd
骤然	mexd
闻名	mexk
核对	meyc
校对	meyc
骤	meyn
杆子	mezw
柱子	mezw
梅	mf
柞	mfae
梏	mfak
梅花	mfcr
枋	mfdg
梅	mfmd
杵	mfod
阏	mfrd
想方设法	mfys
杨	mg
驰	mgag
核工业部	mgal
札	mgd
杠	mgdh
栩	mgll
杠杆	mgme
杨梅	mgmf
驰骋	mgmk
杨柳	mgmp
杨树	mgmy
楹	mgpm
杨	mgpp
桩	mgtd
驰名	mgxk
札记	mgyj
本	mh
木柴	mhab
眄	mhag
桠	mhah
木	mhap
榧	mhaw
本分	mhbd
睐	mhbm
材料	mhbm
木料	mhbm
枰	mhbo
械	mhcd
闭幕	mhcr
本色	mhdb
木头	mhdd
柩	mhdw
杌	mhed
马列主义	mhed
本市	mhej
本职	mhek
本队	mher
驱除	mher
驱动	mhes
木刻	mhew
本院	mhex
本年	mhfh
闩	mhg
朽	mhgd
骁	mhge
桡	mhge
盯	mhgh
木工	mhgh
闭	mhgp
材	mhgp
闱	mhha
本来	mhhb
毯	mhhg
木匠	mhhj
本事	mhhk
驱逐	mhhp
睫	mhir
驱	mhiw
枢	mhiw
眍	mhiw
本钱	mhje
枢纽	mhjw
阑	mhkb
楝	mhkb
阈	mhkd
骊	mhkd
柯	mhkg
木器	mhkk
柄	mhkr
槽	mhkr
本国	mhkw
本部	mhlk
框架	mhlk
李亚松	mhmb
本校	mhme
桎梏	mhmf
框框	mhmh
木材	mhmh
本	mhn
杰	mhnd
本报	mhoe
本届	mhok
木炭	mhoo
本身	mhop
本科	mhpm
本质	mhpp
本行	mhpr
杯	mhrd
本领	mhrd
杰作	mhrf
桓	mhrh
闭合	mhrh
驱使	mhrh
梗	mhri
本位	mhrl
株式会社	mhro
本人	mhrp
柜台	mhsk
桎	mhst
本能	mhsu
本地	mhtg
本土	mhth
睛	mhtu
本月	mhup
本厂	mhvh
杰出	mhwa
本文	mhwd
盹	mhwg
柜	mhww
框	mhww
眶	mhww
栋	mhwx
本性	mhxf
闭塞	mhxh
杯子	mhzw
本子	mhzw
柜子	mhzw
毯子	mhzw
根	mi
眼前	mibh
根基	mics
眼色	midb
根除	mier
概率	miew
楗	miez
毽	miez
概	migg
根瘤	migl
根	mign
眼	mign
棣	mign
眼皮	migp
眼下	miha
棂	mihd
根式	mihg
樊	miid
攀	miio
驳	miit
驳斥	mijd
眼镜	mijl
眼圈	mikb
驳回	mikk
眼力	milg
概况	milk
概述	mimd
根本	mimh
眼睛	mimh
眼眶	mimh
根毛	mimp
根苗	mioc
根据	mioo
概括	miop
眼神	mior
眼看	mipe
根系	mipj
眼科	mipm
概念	mird
驳倒	mirh
眼泪	mism
根治	miss
根源	misv
眼界	mitr
攀登	miwd
眼球	miwh
眼光	mixh
眼窝	mixk
概要	mixn
攀谈	miyh
概论	miyr
根子	mizw
机舱	mjar
瞍	mjay
皙	mjbd
机关	mjbe
机警	mjcd
析	mjda
柝	mjdd
机	mjdg
杞	mjdg
桕	mjdh
睨	mjeh
机动	mjes
机智	mjfd
机制	mjfh
机床	mjgm
闻风而动	mjhe
枫	mjid
机灵	mjih
机组	mjjk
机器	mjkk
机具	mjks
机构	mjmd
机械	mjmh
机枪	mjmr
机身	mjop
机会	mjre
机电	mjrg
机体	mjrm
机件	mjrn
机油	mjsk
机能	mjsu
机场	mjtg
机车	mjvh
机翼	mjwl
橼	mjwn
机密	mjxd
机要	mjxn
问答	mkar
枳	mkbd
问世	mkch
楫	mked
目中无人	mker
问	mkgh
枵	mkhg
桐	mkhk
驶	mkit
闾	mkkg
榀	mkkk
阃	mkmh
杏	mknh
问好	mknz
骋	mkog
柚	mkoh
枧	mkpg
问候	mkra
枘	mkrd
问题	mkrh
机器人	mkrp
桐油	mksk
驵	mkst
问询	mkyd
榇	mlhx
枷锁	mljx
枷	mlkd
标新立异	mlls
梓	mlod
樟	mlro
标准化	mlrq
瞳	mlrt
樟脑	mlue
想	mm
禁止	mmaa
林业	mmaa
马马虎虎	mmaa
瞿	mmah
氍	mmam
相符	mmar
相等	mmat
矍	mmay
相比	mmbb
棼	mmbd
相关	mmbe
想必	mmdg
相	mmdh
杩	mmdh
想象	mmdk
林	mmdn
相干	mmea
郴	mmed
相隔	mmeh
闲聊	mmep
麓	mmgb
闲	mmgd
相应	mmgd
闯	mmgh
楚	mmgr
想来	mmhb
焚	mmhd
焚烧	mmhh
禁区	mmhi
林区	mmhi
禁烟	mmhk
闲事	mmhk
格格不入	mmhp
相互	mmhw
相继	mmjb
梵	mmjd
机构改革	mmjg
相近	mmjz
相距	mmka
相同	mmkh
榈	mmkk
目瞪口呆	mmkk
梦见	mmkp
想见	mmkp
林立	mmld
相加	mmlk
毳	mmmg
林木	mmmh
相机	mmmj
橇	mmmm
彬彬	mmmm
梦想	mmmm
森林	mmmm
森	mmmn
相间	mmmr
婪	mmnd
鹇	mmng
禁	mmod
相声	mmoh
闯祸	mmok
相接	mmol
相抵	mmop
相持	mmot
相片	mmpa
相貌	mmpd
相称	mmpm
彬	mmpp
相反	mmpp
相切	mmqd
禁令	mmrd
相邻	mmrd
想念	mmrd
相传	mmre
相会	mmre
相仿	mmrf
相似	mmrg
楂	mmrh
相合	mmrh
相遇	mmrk
相位	mmrl
闲人	mmrp
机械化	mmrq
相信	mmry
想法	mmst
林场	mmtg
林地	mmtg
相连	mmvz
相处	mmwa
闯劲	mmwd
相通	mmwd
相逢	mmws
梦	mmxd
想	mmxd
相当	mmxi
相宜	mmxk
相对	mmyc
相差	mmyg
闲谈	mmyh
相识	mmyk
闲话	mmyp
株	mnbd
标	mo
标点	moah
樨	moan
标签	moar
樯	mobh
相提并论	moby
榭	mocd
枯黄	moch
枯萎	mocp
标	modd
柘	modh
标高	moek
栊	mogd
椟	mogd
桔	mohk
枯燥	mohk
标致	mohs
桤	mojd
阗	mokb
枯	mokd
标号	mokh
楠	moko
枝叶	moko
植	moks
标准	mola
标榜	mome
标杆	mome
标本	momh
植株	momn
标枪	momr
杖	mond
柰	mond
植物	mond
标志	mooh
椐	mook
标尺	moon
标兵	mopa
瞩	mopd
标量	morh
标题	morh
标价	morr
标明	moru
闳	mosg
马克思主义	motd
马克思列宁主义	motd
马克思	motx
枝条	mowh
榍	moxu
枝	moyd
本报讯	moyg
标语	moyh
标记	moyj
标识	moyk
骣	mozz
极	mp
驯	mpaa
极点	mpah
毛笔	mpam
毛竹	mpap
椴	mpay
毛茶	mpcr
桃花	mpcr
极其	mpcs
骄	mpda
桥	mpda
睡觉	mpdb
桥头	mpdd
极大	mpdh
极为	mpdl
眨	mpdn
眺望	mpeg
极限	mpei
极度	mpgc
柢	mpgd
柳	mpge
栅	mpgh
毛病	mpgl
阍	mpgr
榴	mpgt
骝	mpgt
毛	mphh
毛衣	mpid
毛巾	mpja
毛线	mpje
骢	mpkx
桃	mpld
眺	mpld
极力	mplg
桁架	mplk
极端	mplo
睡意	mplr
栅栏	mpmb
瞅	mpmh
楸	mpmh
板材	mpmh
毛毯	mpmh
眨眼	mpmi
睡梦	mpmm
极板	mpmp
栅极	mpmp
睡眠	mpmw
极左	mpog
睡	mpoh
棰	mpoh
栝	mpok
梃	mpoz
桥牌	mppa
栀	mppg
毛利	mppm
杉	mppp
权衡利弊	mppx
板	mppy
桁	mprg
骄傲	mprh
极化	mprq
驯化	mprq
桥梁	mpsd
桥墩	mpte
极地	mptg
毛坯	mpth
横行霸道	mpub
驯服	mpue
板凳	mpwd
柳条	mpwh
极	mpwn
栎	mpwx
槌	mpwz
极性	mpxf
极小	mpxg
板子	mpzw
桃子	mpzw
间	mr
柙	mrad
闸	mrag
检点	mrah
验算	mram
棍	mrbb
枪毙	mrbb
间断	mrbm
查账	mrbv
查获	mrcq
驸	mrct
检举	mrdb
柃	mrdd
间隔	mreh
闪亮	mrek
桧	mres
檎	mres
闪动	mres
间隙	mrex
查收	mrga
验收	mrga
枪弹	mrgb
闪	mrgd
阀	mrgg
枪	mrgg
间	mrgh
榻	mrgl
检疫	mrgl
榆	mrhd
枪炮	mrhd
闸瓦	mrhg
检	mrhh
验	mrhh
睑	mrhh
查	mrhn
闪烁	mrhp
查办	mrlb
查阅	mrmb
检阅	mrmb
棵	mrmd
阀门	mrmd
闸门	mrmd
检查	mrmr
检验	mrmr
闪闪	mrmr
骒	mrmt
榆树	mrmy
杳	mrnh
间苗	mroc
间接	mrol
查看	mrpe
阒	mrqg
骅	mrqo
桦	mrqo
检修	mrra
枞	mrrd
间歇	mrrd
间作	mrrf
阊	mrrg
闪电	mrrg
查明	mrru
检测	mrsb
检波	mrsg
查清	mrsh
查封	mrtt
栓	mrwd
检录	mrwe
闪现	mrwk
闪光	mrxh
闪耀	mrxh
检察	mrxx
查对	mryc
间谍	mryc
检讨	mryc
查询	mryd
查访	mryf
验证	mryh
棍子	mrzw
棒	ms
阔步	msaa
楔	msad
骏	msbw
梭	msbw
根深蒂固	msck
骖	msdp
闫	msgh
毛泽东思想	mshm
眙	mskh
骀	mskt
骏马	msmw
毪	msng
眸	msnh
梆	mspe
阔	mspk
阔气	msqp
楱	msrd
榛	msrm
棒	msro
椿	msrr
驷	msth
臻	mstm
睃	mswh
棒球	mswh
椤	msxd
桫	msxp
梆子	mszw
棒子	mszw
梭子	mszw
杜	mt
榷	mtad
睦	mtbt
棱	mtbw
桂花	mtcr
杜	mtdh
杜绝	mtjd
骡	mtjt
杜鹃	mtku
枕木	mtmh
桂林	mtmm
瞌睡	mtmp
闺女	mtnw
楮	mtor
栳	mtpb
枕	mtpg
栲	mtpg
眈	mtpg
睹	mtpr
瞑	mtrb
阖	mtsm
瞌	mtsm
桂	mttd
闺	mttg
眭	mtth
骡子	mtzw
棚	mu
樗	mueg
橹	murd
氇	murg
檑	mutd
棚	muud
棚子	muzw
槭	mvad
橛	mvbq
橱	mvdc
枨	mvdn
闽	mvgd
枥	mvld
睚	mvtt
橱窗	mvxp
马	mw
马虎	mwah
马上	mwah
楣	mwam
橙	mwdd
瞪	mwdd
阕	mwdd
睽	mwdd
杼	mwdg
枉	mwdh
橘	mwdk
枚	mwdn
桶	mwdo
懋	mwdx
马达	mwdz
阚	mwew
橄	mwew
瞰	mwew
母	mwgd
闵	mwgd
马	mwgh
闰	mwgh
阁下	mwha
马匹	mwhe
眠	mwhg
格式	mwhg
马灯	mwhh
鼎	mwhw
绦	mwhx
马路	mwka
格	mwkd
阁	mwkg
骆	mwkt
马力	mwlg
母亲	mwlh
母本	mwmh
骆驼	mwmx
母树	mwmy
母女	mwnw
格局	mwog
马克	mwok
母体	mwrm
马车	mwvh
椽	mwwn
格外	mwxa
李文光	mwxh
格言	mwyd
母羊	mwyd
马戏	mwyg
格子	mwzw
档	mx
驼背	mxae
柁	mxbd
驼	mxbt
棕色	mxdb
栖	mxdh
问心无愧	mxex
榨取	mxey
楞	mxfd
榨	mxfe
闷	mxgd
桄	mxhe
柠	mxhg
楦	mxhh
档	mxid
棺材	mxmh
问寒问暖	mxmr
桉树	mxmy
桉	mxnd
棕	mxod
瞟	mxoh
闷热	mxop
骠	mxot
槟	mxpb
杪	mxpd
眇	mxph
栖息	mxpm
榕	mxrk
瞎	mxsk
榨油	mxsk
樘	mxtt
瞠	mxtt
梢	mxud
棺	mxwh
眵	mxxh
档案	mxxn
檫	mxxo
瞎子	mxzw
样	my
权益	mybh
树	mycd
样	myda
杈	mydd
权	mydn
骚	mydv
驿	myea
树干	myea
权限	myei
骚动	myes
槎	mygd
树皮	mygp
样式	myhg
相对而言	myhy
样品	mykk
树立	myld
权力	mylg
树木	mymh
样本	mymh
树林	mymm
树枝	mymo
样板	mymp
样样	mymy
树苗	myoc
骚扰	myoo
权势	myop
权利	mypm
树种	mypm
骚乱	mypo
树丛	myrr
柽	mytd
树冠	myte
驭	mytn
槠	mytr
树脂	myub
权威	myvh
相对误差	myyy
样子	myzw
李	mz
樾	mzhd
李	mznh
你	n
媛	naey
如此而已	nahw
如上所述	napm
如虎添翼	nasw
嫒	naty
朱	nb
朱	nban
嫌疑	nbbf
妣	nbbh
邾	nbea
娣	nbgp
嫌	nbib
姘	nbkh
婢	nbpo
物美价廉	nbrg
婵	nbro
牝	nbtg
媒	nc
鹱	ncay
媒	ncem
嫫	ncrd
媒介	ncrp
物	nd
妁	nddh
物主	ndet
犄	ndhg
娘	ndin
妒忌	ndjx
娩	ndkg
物品	ndkk
妫	ndld
物力	ndlg
物产	ndlp
物资	ndlq
犏	ndoc
妒	ndoh
物	ndpp
物质	ndpp
物体	ndrm
物件	ndrn
物价	ndrr
物理	ndwr
娘家	ndxh
物证	ndyh
娘子	ndzw
妹	neab
奸	neah
姣	nebi
嫡	nebk
婀	nehg
婷	nekg
嬗	nekh
犒	nekk
妹妹	nene
妩媚	nenw
妩	nepg
好高骛远	newe
妹子	nezw
姓	nf
牿	nfak
牲畜	nfew
妨	nfhg
牲口	nfka
妨碍	nfor
姓	nfth
牲	nftt
姓名	nfxk
妨害	nfxs
她	ng
她	ngag
婿	ngau
奶头	ngdd
姒	ngdr
娜	ngee
嫉	ngld
嬷	ngms
嫉妒	ngnd
奶奶	ngng
奶	ngph
她们	ngrm
嫩	nh
娅	nhah
嫣	nhah
牾	nhak
姬	nhaw
媾	nhct
侥	nhge
娆	nhge
姨	nhgr
婕	nhir
妪	nhiw
嫩	nhkw
侥幸	nhtb
婊	nhti
婧	nhtu
好事多磨	nhxg
妇	ni
妇联	nieb
犍	niez
妇	nihh
妇女	ninw
妇人	nirp
嫂	nj
嫂	njay
妃	njhg
始终如一	njnh
嫂子	njzw
如	nk
如此	nkab
如上	nkah
如若	nkco
如其	nkcs
姻	nkdh
娱	nker
姐夫	nker
妍	nkha
如下	nkha
如	nkhh
絮	nkjh
如同	nkkh
娲	nkkr
如意	nklr
姐妹	nkne
姐姐	nknk
娉	nkog
妯	nkoh
娱乐	nkpw
如今	nkrd
如何	nkrh
如是	nkrh
如果	nkrm
犋	nksb
姐	nksh
娟	nkuh
如月	nkup
如实	nkxd
恕	nkxh
嫜	nlro
妈	nm
姆	nmhd
妈	nmhh
娴	nmmh
妈妈	nmnm
牦	nmtg
姝	nnbh
姗姗来迟	nnho
妮	no
妮	nobh
嫱	nobh
姑父	nobi
嬉	nodk
犊	nogd
姑	nokh
姑且	noks
妙手回春	noks
牯	nokt
娓	nomh
姑娘	nond
姑妈	nonm
如饥似渴	nora
媸	nowa
妓	noyh
牛	np
媲美	npbw
物质财富	npbx
娇	npda
妖	npdh
鸟	npgd
姗	npgh
姊	npgp
婚	npgr
媲	npkb
姚	npld
媳	npmx
姊妹	npne
媳妇	npni
婚姻	npnk
娥	npod
婚礼	npog
妊	npoh
物质文明	npwr
妗	nrdw
妲	nrhh
媪	nrmh
娼妓	nrno
娼	nrrh
娌	nrth
始	ns
始终	nsjw
始	nskh
特	nt
特此	ntab
特点	ntah
特	ntct
特色	ntdb
特大	ntdh
特效	nteb
特制	ntfh
特区	nthi
特殊	nthx
嫘	ntjh
特级	ntjp
特别	ntkl
特产	ntlp
特意	ntlr
特权	ntmy
娃娃	ntnt
特有	ntou
姥	ntpb
牡丹	ntpg
特种	ntpm
特征	ntpr
特使	ntrh
特地	nttg
牡	ntth
娃	ntth
特长	ntvp
特务	ntwl
特性	ntxf
特定	ntxh
孀	numm
娠	nv
娠	nven
女	nw
牧业	nwaa
媚	nwam
牧草	nwcr
妤	nwdg
女儿	nwep
女工	nwgh
牧区	nwhi
女婿	nwng
女士	nwoh
女	nwph
女人	nwrp
牧场	nwtg
妞	nwth
牧	nwtn
牧民	nwwh
女性	nwxf
女孩	nwze
女子	nwzw
婶	nx
鸵	nxbh
嫁	nxhn
嫖	nxoh
嫁接	nxol
嫔	nxpb
妙	nxph
姹	nxpq
婶	nxra
嫦	nxtj
婉	nxxg
努	ny
弩	nygh
怒火	nyhd
奴才	nyhg
奴	nyhn
奴隶	nyig
帑	nyjh
胬	nykr
怒吼	nykz
努力	nylg
努	nylh
驽	nymh
奴役	nypr
怒气	nyqp
怒	nyxh
孥	nyzh
好些	nzab
好战	nzah
好笑	nzap
好受	nzat
好比	nzbb
好的	nzbd
好学	nzdb
好奇	nzdh
好象	nzdk
好久	nzdn
好	nzhh
好事	nzhk
好不	nzhr
好歹	nzhx
好吃	nzkf
好听	nzkj
好意	nzlr
妙趣横生	nzmf
牺牲	nznf
好好	nznz
好在	nzoa
好看	nzpe
好人	nzrp
好汉	nzsy
牺	nzth
好坏	nzth
好转	nzve
好感	nzvh
好处	nzwa
好心	nzxd
好客	nzxw
好多	nzxx
好说	nzyb
好评	nzyh
好话	nzyp
是	o
山	oa
在业	oaaa
抓紧	oaaa
在此	oaab
揽	oaag
崔	oaah
存盘	oaam
推算	oaam
授粉	oabm
推断	oabm
山谷	oabr
携带	oaca
在世	oach
推荐	oaco
捋	oact
推举	oadb
掉头	oadd
山头	oadd
摇头	oadd
抓斗	oadd
祉	oadh
扑	oadt
山峦	oaea
在于	oaeg
推敲	oaek
在职	oaek
推进	oaep
掉队	oaer
排除	oaer
排队	oaer
搬动	oaes
搬运	oaes
推动	oaes
摇动	oaes
按步就班	oaew
援	oaey
推选	oafa
在先	oafa
摇	oaft
存放	oafw
援引	oaga
推广	oagd
携	oagp
扯皮	oagp
在座	oagr
在下	oaha
祯	oahb
山顶	oahg
援救	oahg
礁	oahh
碓	oahh
扑灭	oahh
山区	oahi
拈	oahk
砧	oahk
山歌	oahk
掳	oahl
掉	oaho
山东	oahw
摅	oahx
排列	oahx
排斥	oajd
在编	oajd
排练	oajh
推销	oajx
搬	oajy
山路	oaka
在内	oakr
援助	oaks
授奖	oala
犀	oaln
授意	oalr
在意	oalr
推杆	oame
砧木	oamh
存根	oami
山根	oami
攥	oamj
山林	oamm
山麓	oamm
推想	oamm
存档	oamx
授权	oamy
馁	oang
存在	oaoa
推迟	oaod
礁石	oaoh
存折	oaoj
扑克	oaok
携手	oaop
山岭	oaor
存款	oaos
摇摆	oaos
排挤	oaow
山峰	oaow
推崇	oaox
排版	oapa
山川	oapa
推翻	oapb
在乎	oapb
岿	oapi
推移	oapm
推辞	oapo
推行	oapr
故步自封	oapt
排气	oaqp
展览会	oare
摇曳	oarg
推倒	oarh
在位	oarl
存货	oarq
摇晃	oarx
存储	oary
授信	oary
推测	oasb
排灌	oasc
排泄	oasc
山洪	oasc
推导	oasc
山沟	oasd
排水	oasg
山水	oasg
山河	oash
排	oass
排场	oatg
山地	oatg
山坡	oatg
在场	oatg
扯	oath
推	oath
抓	oatn
在	oatp
在教	oatp
授	oaty
山脉	oaud
山脚	oaut
山腰	oaux
掉转	oave
排长	oavp
山	oawa
推出	oawa
扑通	oawd
授予	oawd
排球	oawh
推理	oawr
在理	oawr
援外	oaxa
存心	oaxd
在心	oaxd
搬家	oaxh
山西	oaxh
山寨	oaxh
在家	oaxh
扯谎	oayc
山羊	oayd
推论	oayr
存	oazp
把	ob
岜	obag
指点	obah
磁盘	obam
揩	obbb
把关	obbe
批判	obbe
砒	obbh
磁道	obbh
指数	obbm
撄	obbn
屁	obbp
批	obbt
磁带	obca
屏幕	obcr
屏蔽	obcx
磁头	obdd
指头	obdd
扮	obdt
拌	obea
饼干	obea
掷	obee
指望	obeg
拦阻	obek
屏障	obel
丧失	obfd
嶷	obfr
批复	obfr
指引	obga
碰巧	obgh
指正	obha
搛	obhb
碰	obhh
啬	obhh
丧事	obhk
丧	obhn
磁	obhs
嵫	obhs
指责	obht
搠	obhu
磁铁	objf
屏风	obji
指针	objo
批改	objw
饼	obkg
扒开	obkh
拦网	obki
屏	obkp
碰见	obkp
拼	obkt
批准	obla
磁力	oblg
屡次	oblq
拼音	oblr
拼凑	obls
磷	obma
嶙	obma
批阅	obmb
把门	obmd
搂	obmn
屡	obmn
嵝	obmn
指标	obmo
屎	obmp
擞	obmw
拍摄	oboe
拍卖	obog
尼龙	obog
磁石	oboh
批示	oboh
指示	oboh
碰壁	obok
指南	obok
碰撞	obol
把握	oboo
拍手	obop
把手	obop
把持	obot
指挥	obot
尼	obpg
指向	obpk
碑	obpo
捭	obpo
嵬	obps
丧气	obqp
指甲	obra
拍照	obrd
指令	obrd
拦住	obre
批量	obrh
拼命	obrh
指使	obrh
峪	obrk
磁体	obrm
掸	obro
禅	obro
磁化	obrq
指	obrt
指明	obru
指导	obsc
拦	obst
扮演	obsx
把	obtg
磁场	obtg
拍	obth
拼写	obth
扒	obtn
指教	obtp
磷肥	obub
屁股	obuj
指出	obwa
禚	obwh
批发	obwp
把守	obxc
磁心	obxd
磁性	obxf
指定	obxh
撙	obyc
把戏	obyg
批评	obyh
磷酸	obys
拍子	obzw
掸子	obzw
展	oc
卉	ocaa
展览	ocaa
射箭	ocab
贲	ocba
按劳分配	ocby
展望	oceg
拉萨市	ocej
射击	oceo
嵌	oceq
硭	ocew
按劳取酬	ocey
措施	ocff
殿下	ocha
拱	ochb
磺	ochb
搭救	ochg
碟	ochm
揲	ochm
展	ochn
措	ochr
馑	ocht
臀	ochu
撒	ochw
屉	ochw
馓	ochw
殿	ochy
砹	ocih
射线	ocje
撕毁	ocjg
描绘	ocjr
展销	ocjx
苗圃	ockh
展开	ockh
展品	ockk
描述	ocmd
射门	ocmd
苗木	ocmh
拱桥	ocmp
搭档	ocmx
撒娇	ocnp
展示	ocoh
射手	ocop
摸索	ocot
射	ocpd
措辞	ocpo
摸	ocrd
馍	ocrd
射影	ocre
搭	ocrk
搽	ocrx
祺	ocsb
礴	ocsc
撕	ocsj
描写	octh
捞	octl
崂	octl
嵘	octm
礞	octn
苗	octt
描	octt
撒腿	ocui
披荆斩棘	ocvh
展出	ocwa
展现	ocwk
礤	ocxo
撒谎	ocyc
搭配	ocyj
搭讪	ocyo
挝	oczt
换	od
确凿	odaa
换算	odam
喜爱	odat
护送	odbe
迟疑	odbf
搅	odbg
抱歉	odbh
掬	odbm
掩盖	odbw
撩	odbx
操之过急	odcd
喜鹊	odch
掩藏	odcv
掩蔽	odcx
抱负	oddb
抖	oddo
挎包	odds
挎	odeg
福州市	odej
招聘	odek
抖动	odes
鼓动	odes
搅动	odes
换取	odey
鼓舞	odfc
掏	odft
招生	odft
招收	odga
招工	odgh
持之以恒	odgx
崎	odhg
掎	odhg
挽救	odhg
拘束	odhk
喜事	odhk
迟到	odhs
招致	odhs
挣	odig
峥	odig
迟缓	odja
馅	odjg
迟钝	odjh
鼓风	odji
掐	odjt
喜	odka
岣	odka
鼓足	odka
搀	odkd
馋	odkd
换	odkd
挽	odkg
熹	odkh
挽回	odkk
招呼	odkp
鼓吹	odkq
振兴中华	odkr
拘	odkt
招	odkt
嘉奖	odla
确立	odld
嘉	odlk
招架	odlk
护林	odmm
招标	odmo
喜好	odnz
抖擞	odob
搅拌	odob
碥	odoc
招展	odoc
迟迟	odod
掩护	odod
搀扶	odoe
喜报	odoe
掩饰	odof
挣扎	odog
护士	odoh
崎岖	odoh
瞽	odom
鼙	odoo
捩	odoq
护	odot
捺	odot
掮	odou
鼓	odoy
招牌	odpa
甏	odpd
拘留	odpg
挽留	odpg
饱和	odpm
搀和	odpm
彭	odpp
拘役	odpr
招待	odpr
确切	odqd
换气	odqp
峋	odra
饱含	odrd
掩	odrg
崦	odrg
确保	odrk
掩映	odrk
迟早	odro
确信	odry
饱满	odsc
饱	odsg
抱	odst
招考	odtp
确	odua
挣脱	odub
抛头露面	oduh
鼓励	odvh
礻	odwa
护理	odwr
喜悦	odxb
确实	odxd
抱怨	odxg
确定	odxh
鼓掌	odxt
拘谨	odyc
喜讯	odyg
喜欢	odyq
确认	odyr
换句话说	odyy
迟	odzp
挞	odzt
报	oe
矸	oeah
抗战	oeah
报答	oear
磅	oebf
报道	oebh
饺	oebi
磙	oebi
碲	oebj
摘	oebk
搞鬼	oebp
破除迷信	oebr
抚养	oebs
报账	oebv
有效期	oecs
提高警惕	oecx
祁	oeda
掠夺	oedc
砖头	oedd
扭亏为盈	oedg
报刊	oeea
十六进制	oeef
撤离	oeei
南京市	oeej
撤职	oeek
抗击	oeeo
撤除	oeer
摘除	oeer
抚育	oees
揶	oeet
摄取	oeey
报告	oefa
十进制	oefh
报复	oefr
摘引	oega
饯	oegd
报应	oegd
饵	oegh
抗病	oegl
报废	oegw
屙	oehg
报到	oehs
报表	oeht
撤退	oeig
报纸	oejp
抗	oejt
报销	oejx
擅	oekh
攘	oeki
禳	oeki
搞	oekk
嵩	oekk
撤回	oekk
礅	oekw
掠	oekx
崞	oekz
层次	oelq
扶植	oemo
搞好	oenz
抚摸	oeoc
硫磺	oeoc
报喜	oeod
撤换	oeod
拐弯抹角	oeod
层层	oeoe
抗拒	oeoh
摄食	oeop
报社	oeot
扶持	oeot
撤兵	oepa
抚顺	oepa
抚	oepg
摄氏	oepg
擅自	oepm
报刊杂志	oepo
托儿所	oepp
掭	oerd
抗旱	oere
摄影	oere
掖	oern
碎	oero
报仇	oerp
硫化	oerq
报价	oerr
扶	oert
撵	oerv
报信	oery
报导	oesc
硫	oesg
层	oesp
搞活	oesp
撤	oesw
撤消	oesx
报考	oetp
拄	oett
十二月	oeup
擅长	oevp
接二连三	oevs
砖	oewd
抟	oewd
摘录	oewe
摔	oewo
搐	oewt
报名	oexk
报案	oexn
摘要	oexn
报酬	oeyd
抗议	oeyd
报请	oeyh
抗诉	oeyj
摘记	oeyj
硫酸	oeys
报	oeyt
摄	oeyy
撤走	oezh
饺子	oezw
拖	of
攒	ofab
祚	ofae
砟	ofae
屹	ofga
拖	ofgg
饰	ofjg
手舞足蹈	ofkk
屹立	ofld
饬	oflg
拖延	ofpa
报告文学	ofwd
矿业	ogaa
手工业	ogaa
掂	ogak
尴	ogam
破旧	ogar
垄断	ogbm
饲料	ogbm
饲养	ogbs
礼节	ogcg
摭	ogch
扩散	ogch
破获	ogcq
礼花	ogcr
尤其	ogcs
矿藏	ogcv
礼	ogd
卖	ogdd
尥	ogdd
龙头	ogdd
觌	ogdg
扩大	ogdh
矿房	ogdo
尤	ogdp
扬州	ogdp
拟	ogdr
局限	ogei
袭击	ogeo
矿井	ogep
破除	oger
扩充	oges
挪动	oges
挪	oget
拟制	ogfh
矿工	oggh
矿床	oggm
推广应用	oggu
扩张	oggv
破烂	oghb
礼炮	oghd
破灭	oghh
矿区	oghi
饲	oghk
祠	oghk
矿	oghp
局面	oghp
左面	oghp
破裂	oghx
找寻	ogic
扩建	ogie
搪	ogik
礼品	ogkk
局	ogkp
卖国	ogkw
矿浆	ogla
局部	oglk
搦	ogll
矿产	oglp
破产	oglp
搪瓷	oglq
左边	oglz
龙门	ogmd
矿柱	ogme
扎根	ogmi
矿物	ognd
礼物	ognd
尤如	ognk
矿山	ogoa
扩展	ogoc
破碎	ogoe
尴尬	ogog
矿石	ogoh
破损	ogok
左右	ogok
局势	ogop
左手	ogop
尢	ogp
拂	ogpa
砩	ogpa
龚	ogpb
龙	ogpd
礼貌	ogpd
聋	ogpe
礼拜	ogpe
躬	ogpg
左	ogph
袭	ogpi
拟稿	ogpm
扬程	ogpm
砻	ogpo
扬	ogpp
饧	ogpp
砀	ogpp
垄	ogpt
扔	ogpt
披	ogpy
破	ogpy
尬	ogra
破例	ogrh
局促	ogrk
矿体	ogrm
左派	ogsp
扎	ogt
找	ogtd
扛	ogth
破坏	ogth
扩	ogtp
扩军	ogtv
挪用	ogua
礼服	ogue
左转	ogve
挪威	ogvh
局长	ogvp
矿长	ogvp
掉以轻心	ogvx
扎实	ogxd
拟定	ogxh
礼堂	ogxt
扬言	ogyd
拟订	ogyh
十	oh
十	oha
士	oha
博览	ohaa
捂	ohak
打算	oham
硬盘	oham
博爱	ohat
拥政爱民	ohaw
峡	ohbd
挟	ohbd
硖	ohbd
十分	ohbd
吉普	ohbh
崃	ohbm
打断	ohbm
砰	ohbo
抨	ohbo
灰白	ohbp
峡谷	ohbr
拉丁美洲	ohbs
打赌	ohbt
打败	ohbw
声带	ohca
石英	ohck
捕获	ohcq
示范	ohcs
博学	ohdb
灰色	ohdb
声誉	ohdb
搏斗	ohdd
石头	ohdd
有求必应	ohdg
抹煞	ohdi
硬朗	ohdi
福州	ohdp
躯干	ohea
石膏	ohek
搏击	oheo
打击	oheo
抨击	oheo
打动	ohes
石刻	ohew
硬度	ohgc
拭	ohgd
挠	ohge
饶	ohge
硗	ohge
打	ohgt
屿	ohgt
扌	ohgt
打下	ohha
示	ohhg
屋顶	ohhg
十一	ohhh
声速	ohhk
视而不见	ohhk
灰烬	ohho
十万	ohhp
屋面	ohhp
福建	ohie
打退	ohig
抹杀	ohih
捷	ohir
抠	ohiw
躯	ohiw
岖	ohiw
拒绝	ohjd
打针	ohjo
砸	ohjw
吉	ohka
十足	ohka
颉	ohkb
石墨	ohkb
岢	ohkg
打开	ohkh
攮	ohki
馕	ohki
打听	ohkj
身不由己	ohkj
石器	ohkk
声响	ohkp
福	ohkt
打架	ohlk
屋架	ohlk
声音	ohlr
示意	ohlr
石棉	ohmb
石门	ohmd
石柱	ohme
吉林	ohmm
盔	ohmp
石板	ohmp
石榴	ohmp
抹	ohmt
声母	ohmw
博物	ohnd
声援	ohoa
打扮	ohob
石碑	ohob
捕捞	ohoc
打捞	ohoc
打搅	ohod
打碎	ohoe
热火朝天	ohoe
打破	ohog
博士	ohoh
石灰	ohoh
硕士	ohoh
志士	ohoh
打扫	ohoi
捕捉	ohok
打扰	ohoo
饥不择食	ohoo
捕食	ohop
打手	ohop
声势	ohop
吉祥	ohoy
石	ohpa
士兵	ohpa
硕	ohpb
颛	ohpb
打印	ohpg
打杂	ohpg
志向	ohpk
福利	ohpm
吉利	ohpm
声称	ohpm
灰	ohpn
打入	ohpn
打乱	ohpo
博得	ohpr
捷径	ohpr
声乐	ohpw
遄	ohpz
打猎	ohqc
打气	ohqp
福气	ohqp
士气	ohqp
志气	ohqp
盔甲	ohra
打住	ohre
打倒	ohrh
打量	ohrh
示例	ohrh
硬	ohri
灰暗	ohrl
躯体	ohrm
硬件	ohrn
打仗	ohro
硬化	ohrq
声明	ohru
揠	ohrw
打滚	ohse
声波	ohsg
硬水	ohsg
石油	ohsk
屋	ohst
碛	ohtb
壹	ohtd
壶	ohth
礓	ohth
壳	ohtj
碡	ohtm
石块	ohtw
懿	ohtx
悫	ohtx
彀	ohty
毂	ohty
觳	ohty
硬脂	ohub
博	ohuc
搏	ohuc
捕	ohud
捕鱼	ohup
十月	ohup
十一月	ohup
志愿	ohvb
石蜡	ohvc
示威	ohvh
拣	ohwb
罄	ohwf
饨	ohwg
砘	ohwg
磬	ohwo
声	ohwp
岈	ohwp
砑	ohwp
打发	ohwp
馨	ohwr
拒	ohww
岽	ohwx
謦	ohwy
志	ohxa
吉它	ohxb
灰心	ohxd
真才实学	ohxd
山东省	ohxp
灰尘	ohxt
打字	ohxz
十字	ohxz
硬说	ohyb
声调	ohyp
志趣	ohze
石子	ohzw
扫	oi
扫荡	oics
扫除	oier
扫帚	oiit
捃	oikt
扫描	oioc
扫射	oioc
扫视	oiok
崤	oiou
扫	oith
福建省	oixp
布	oj
投篮	ojaa
岂	ojag
屺	ojag
搜集	ojam
折旧	ojar
搜	ojay
馊	ojay
蜇	ojbt
饥荒	ojce
拆散	ojch
逝世	ojch
躲藏	ojcv
祈	ojda
剀	ojda
哲学	ojdb
矾	ojdh
投奔	ojdo
刷	ojdp
拆	ojdt
拆除	ojer
投降	ojew
布告	ojfa
投靠	ojfa
拆卸	ojfo
投放	ojfw
投弹	ojgb
饥	ojgg
折磨	ojgm
斫	ojha
身经百战	ojha
布匹	ojhe
矶	ojhg
祈求	ojhg
布面	ojhp
岂不	ojhr
拾金不昧	ojhr
岚	ojia
搜寻	ojic
砜	ojih
凯	ojja
折线	ojje
拆毁	ojjg
折中	ojka
觊	ojkg
拆开	ojkh
踅	ojkr
哲	ojkt
投产	ojlp
投资	ojlq
投机	ojmj
投标	ojmo
躲	ojmp
搜查	ojmr
投梭	ojms
投掷	ojob
投射	ojoc
折射	ojoc
布局	ojog
躲避	ojok
折扣	ojok
饥饿	ojop
投身	ojop
搜索	ojot
布	ojpa
投稿	ojpm
投入	ojpn
掀	ojqt
揿	ojqt
布景	ojre
投影	ojre
展销会	ojre
折合	ojrh
克己奉公	ojsb
布满	ojsc
刷洗	ojsf
拆台	ojsk
布置	ojso
折	ojta
拆封	ojtt
饥民	ojwh
哲理	ojwr
投票	ojxo
誓言	ojyd
誓	ojyt
投	ojyt
投诚	ojyv
折叠	ojyy
掀起	ojzj
逝	ojzt
刷子	ojzw
故	ok
岍	okaa
视频	okaa
馈	okab
南北	okae
古	okah
献策	okah
捉	okar
南非	okas
真的	okbd
祖父	okbi
南	okbo
献	okbq
损	okbt
挹	okbt
古巴	okbw
南美	okbw
碘	okcb
真菌	okck
古董	okcp
操劳	okct
辜负	okdb
视觉	okdb
直觉	okdb
硎	okdh
避免	okdk
抽象	okdk
直角	okdu
摁	okdx
直达	okdz
克	okea
拐弯	okea
祝	oked
兢	okee
南京	okek
故障	okel
古迹	okep
真迹	okep
扣除	oker
南阳	oker
抽动	okes
揖	oket
祖先	okfa
南方	okfd
损失	okfd
右方	okfd
克制	okfh
研制	okfh
食品工业	okga
胡麻	okgm
研磨	okgm
研	okha
南亚	okha
真正	okha
直爽	okhi
峒	okhk
硐	okhk
抽烟	okhk
故事	okhk
南面	okhp
右面	okhp
直到	okhs
直至	okhs
壁画	okht
岗	okia
直隶	okig
视线	okje
直线	okje
操练	okjh
避风	okji
操纵	okjr
献给	okjr
古典	okkc
避开	okkh
胡同	okkh
操	okkm
祸	okkr
视图	okkw
祖国	okkw
捌	okld
劈	okld
璧	okld
甓	okld
矗立	okld
视力	oklg
襞	okli
鐾	oklj
南部	oklk
祝贺	oklk
檗	oklm
嬖	okln
辟	oklo
辜	oklo
擘	oklo
故意	oklr
壁	oklt
拐	oklt
臂	oklu
譬	okly
避	oklz
南边	oklz
右边	oklz
胡椒	okma
胡闹	okme
捆	okmh
真相	okmm
抽查	okmr
祖母	okmw
抽样	okmy
鸪	okna
避嫌	oknb
譬如	oknk
抽屉	okoc
捉摸	okoc
献礼	okog
抽	okoh
届	okoh
岫	okoh
崮	okoh
祝福	okoh
捐献	okok
直接	okol
直尺	okon
献身	okop
右手	okop
真挚	okop
直播	okop
直属	okop
扣押	okor
南朝	okor
操持	okot
视	okpg
砚	okpg
岘	okpg
扣留	okpg
右	okph
捐税	okpm
胡乱	okpo
胡须	okpp
南瓜	okpp
直径	okpr
真切	okqd
右倾	okrb
届时	okrc
古今	okrd
操作	okrf
损伤	okrf
颠倒	okrh
古代	okrh
真是	okrh
捉拿	okrh
岗位	okrl
古人	okrp
南昌	okrr
避暑	okrt
视野	okrt
损耗	oksa
颠	oksb
真	oksb
祖	oksd
直流	okse
南海	oksf
直	oksh
抽泣	oksl
矗	okss
碘酒	oksy
操场	oktg
扣	okth
损坏	okth
古老	oktp
胡	okua
臂膀	okue
克服	okue
鹕	okun
捐	okut
祝愿	okvb
直辖	okvx
故	okwa
掴	okwh
右翼	okwl
真理	okwr
故乡	okww
嘏	okwy
操心	okxd
真实	okxd
真心	okxd
抽空	okxg
真空	okxg
南宁	okxh
故宫	okxk
南宋	okxm
祖宗	okxo
颠覆	okxp
研究	okxp
祸害	okxs
损害	okxs
视察	okxx
古怪	okxy
避难	okya
胡说	okyb
避讳	okyh
直观	okyk
献计	okyo
抽调	okyp
真诚	okyv
胡子	okzw
扣子	okzw
拉	ol
接受	olat
接管	olax
协	olba
拉萨	olce
接头	oldd
接触	oldu
协商	oleb
撞击	oleo
接替	oler
接收	olga
接应	olgd
砬	olhh
协约	oljd
接线	olje
接近	oljz
接口	olka
碚	olkh
拉开	olkh
协同	olkh
接见	olkp
协助	olks
掊	olkt
接力	ollg
拉力	ollg
协力	ollg
矿产资源	olls
拉杆	olme
接	olnt
拉扯	oloa
拉拢	oloo
接手	olop
裘	olpi
接种	olpm
接待	olpr
协会	olre
协作	olrf
接合	olrh
拉倒	olrh
嶂	olro
拉伸	olrr
撞	olrt
揞	olrt
接洽	olsr
接地	oltg
拉	olth
拉长	olvp
接连	olvz
接通	olwd
协定	olxh
拼音字母	olxm
协议	olyd
接着	olym
协调	olyp
尾	om
崧	ombs
尾巴	ombw
有目共睹	omcm
码头	omdd
尾随	omeo
碴儿	omep
技术交流	omes
攫取	omey
技术革新	omgl
技术革命	omgr
码	omhh
技术员	omkb
技术开发部	omkl
技术咨询	omly
撬	ommm
攫	ommy
拇指	omob
有根有据	omoo
喜马拉雅山	omoo
尾	ompg
碴	omrh
揸	omrh
馇	omrh
南极洲	omsd
搁置	omso
拇	omtd
扪	omtg
搁	omwk
尾翼	omwl
吉林省	omxp
尽	on
尽管	onax
尺寸	onch
尽	ondd
尽头	ondd
丈夫	oner
昼夜	oner
尺度	ongc
咫	onkb
尽力	onlg
尺码	onom
博物馆	onox
尺	onp
丈	onp
昼	onrh
尽量	onrh
尽是	onrh
尽情	onxh
尽快	onxw
尺子	onzw
据	oo
兢兢业业	ooaa
据此	ooab
岩	ooah
据点	ooah
技师	ooap
摧	ooat
岂有此理	ooaw
摒	oobk
拔节	oocg
技艺	oocg
熨	ooch
碾	oocn
搌	oocn
尉	oocp
磊落	oocs
慰劳	ooct
慰	oocx
熨斗	oodd
禧	oodk
挑拨离间	ooem
掘进	ooep
扰动	ooes
剧院	ooex
拢	oogd
扰	oogd
技工	oogh
技巧	oogh
剧痛	oogl
揣摩	oogm
揣	ooha
炭	ooha
撷	oohb
拮	oohk
措手不及	oohp
握	ooht
剧毒	ooht
挺身而出	oohw
摧残	oohx
剧烈	oohx
摧毁	oojg
饱食终日	oojr
岵	ooka
拓跋	ooka
巅	ookb
剧	ookd
祜	ookd
剧团	ookh
擗	ooko
居	ookp
剧目	ooma
技术	oomd
技校	oome
剧本	oomh
慰问	oomk
岩层	oooe
磊	oooh
碳	oooh
岩石	oooh
据	oook
握手	ooop
据悉	oopb
扰乱	oopo
居住	oore
握住	oore
擀	ooro
技法	oost
技能	oosu
剧场	ootg
拓	ooth
饽	ootz
居民	oowh
掘	oowo
崛	oowo
居然	ooxd
打破常规	ooxe
岐	ooya
据说	ooyb
拔	ooyd
祓	ooyd
碳酸	ooys
技	ooyt
手	op
身	opag
身上	opah
挑战	opah
热爱	opat
身分	opbd
播送	opbe
食道	opbh
食粮	opbm
捣鬼	opbp
食欲	opbr
播	opbt
履带	opca
热带	opca
手艺	opcg
身世	opch
挢	opda
峤	opda
祆	opdd
插头	opdd
手头	opdd
饫	opdg
势必	opdg
手套	opdh
砭	opdn
抵触	opdu
抵达	opdz
属于	opeg
挺进	opep
抛弃	opes
托运	opes
挑选	opfa
抵制	opfh
抑制	opfh
饭店	opga
托收	opga
贽	opgb
抵	opgd
执	opgd
祗	opgd
砥	opgd
抑	opge
峁	opge
饣	opgg
热	opgh
手工	opgh
絷	opgj
碉	opgk
抛	opgl
势	opgl
鸷	opgn
捣	opgo
挚	opgo
尻	opgp
插座	opgr
垫	opgt
馏	opgt
蛰	opgv
祢	opgx
手下	opha
执政	opha
手	ophh
抵赖	ophk
插页	ophp
手表	opht
热烈	ophx
手巾	opja
手帕	opjb
抛锚	opjc
履约	opjd
捣毁	opjg
热风	opji
手绢	opjk
手续	opjo
插销	opjx
插嘴	opka
手足	opka
垫圈	opkb
属	opkd
硇	opkh
括号	opkh
括	opkk
饷	opkk
食品	opkk
挑唆	opks
插图	opkw
挑	opld
祧	opld
挺立	opld
热力	oplg
势力	oplg
播音	oplr
嵴	oplu
身边	oplz
擤	opma
热门	opmd
手术	opmd
热闹	opme
揪	opmh
身材	opmh
手柄	opmh
热机	opmj
打印机	opmj
手杖	opmo
手枪	opmr
巍	opms
食	opnd
食物	opnd
嵊	opob
食指	opob
手指	opob
峨	opod
饿	opod
硪	opod
抵抗	opoe
捶	opoh
饪	opoh
身躯	opoh
插	opoj
挺拔	opoo
扳手	opop
插手	opop
身手	opop
手势	opop
巍峨	opop
抵押	opor
扦	opot
挑拨	opow
执拗	opow
抵挡	opox
饭馆	opox
饭碗	opox
挺	opoz
垫片	oppa
身段	oppa
手段	oppa
手册	oppg
拨乱反正	opph
搋	oppj
播种	oppm
插秧	oppm
热血	oppm
手稿	oppm
挑衅	oppm
插入	oppn
捣乱	oppo
身后	oppp
招待所	oppp
抵御	oppr
履行	oppr
执行	oppr
扳	oppy
饭	oppy
热切	opqd
热气	opqp
托	opqt
身份	oprb
托付	oprc
挑剔	oprd
执照	oprd
热量	oprh
碉堡	oprk
身体	oprm
屦	oprn
屣	oprr
履	oprw
抵偿	oprx
屐	opry
热流	opse
热水	opsg
热泪	opsm
热潮	opso
手法	opst
执法	opst
热能	opsu
势能	opsu
热源	opsv
抵消	opsx
食盐	opta
食用	opua
手脚	oput
手腕	opux
热轧	opvg
手感	opvh
履历	opvl
热压	opvt
插条	opwh
手球	opwh
岌	opwn
播发	opwp
砾	opwx
热心	opxd
身心	opxd
手心	opxd
属实	opxd
食性	opxf
属性	opxf
热情	opxh
热忱	opxt
食堂	opxt
手掌	opxt
热诚	opyv
挑起	opzj
垫子	opzw
身子	opzw
砌	oq
饮料	oqbm
朝气蓬勃	oqco
砌	oqdh
有气无力	oqel
饩	oqgg
饮	oqgn
砍	oqhn
饮食	oqop
砍伐	oqrg
饮水	oqsg
喜气洋洋	oqss
饮用	oqua
提	or
岬	oraa
神	orad
砷	orah
提督	orah
神采	oram
押	orat
抻	orat
馄	orbb
押送	orbe
提前	orbh
社会公德	orbp
社会关系	orbp
提单	orbr
抡	orbt
提花	orcr
拊	orct
担负	ordb
神色	ordb
神学	ordb
抢夺	ordc
拎	ordd
岭	ordd
馒头	ordd
神态	ordd
神奇	ordh
提包	ords
揭	ordw
岑	ordw
碣	ordw
捻	ordx
捍	orea
提交	oreb
碍	ored
社会主义	ored
提防	oref
南昌市	orej
提高	orek
操作规程	orep
朝阳	orer
抢险	orer
擒	ores
乾隆	orew
馀	orex
撮	orey
提取	orey
捏造	orfa
抢先	orfa
捍卫	orga
抢	orgg
砼	orgh
拽	orgp
朝政	orha
揄	orhd
嵛	orhd
抢救	orhg
硷	orhh
捡	orhh
提炼	orhh
拾	orhk
碍事	orhk
提	orhr
担	orht
提纯	orjh
提纲	orjk
押金	orjp
神经	orjw
操作员	orkb
揭开	orkh
存储器	orkk
担架	orlk
身体力行	orlp
押韵	orlr
提问	ormk
有何特长	ornv
韩	oroa
揭批	orob
十全十美	orob
乾	orog
戟	orog
揭示	oroh
提示	oroh
挫折	oroj
翰	orol
斡	oroo
提拔	oroo
朝	orou
提升	orpc
社会科学	orpd
操作系统	orpj
朝向	orpk
神秘	orpm
朝廷	orpo
担待	orpr
神往	orpr
神气	orqp
抢修	orra
赍	orrb
提供	orrc
挫伤	orrf
朝代	orrh
撮合	orrh
揭晓	orrh
擒拿	orrh
担保	orrk
麴	orrm
神仙	orro
提早	orro
担任	orrp
提货	orrq
提倡	orrr
挫	orrt
提法	orst
馒	orsy
抢劫	orts
捏	ortt
揭露	oruk
朝鲜	oruy
提成	orvg
有偿转让	orvy
提出	orwa
神通	orwd
揭发	orwp
拴	orwt
担心	orxd
揭穿	orxh
神情	orxh
担当	orxi
社会实践	orxk
提案	orxn
提要	orxn
担忧	orxo
按时完成	orxv
提议	oryd
提请	oryh
朝着	orym
神话	oryp
提醒	oryr
神圣	oryt
担子	orzw
禊	osad
雄	osap
饴糖	osbm
峻	osbw
拚	osct
雄蕊	oscx
抬举	osdb
抬头	osdd
祀	osdg
掺	osdp
碜	osdp
抬高	osek
摆动	oses
挨	osfd
款项	osgh
热泪盈眶	osgm
擐	oshi
磲	oshm
泵	oshn
尿素	osht
挨近	osjz
饴	oskg
抬	oskt
雄壮	osla
雄辩	oslo
挨打	osoh
峻岭	osor
祷	ospc
掺杂	ospg
尿	ospn
款待	ospr
揍	osrd
雄伟	osrh
捧	osro
撰	ossb
馔	ossb
捧场	ostg
撰写	osth
指导思想	ostm
摆	osts
摆脱	osub
雄厚	osvr
摆弄	oswc
雄心	osxd
款	osxq
摆设	osyj
挨着	osym
社	ot
拷贝	otba
探	otbm
峙	otca
持	otct
社	otdh
持久	otdn
社交	oteb
探望	oteg
探险	oter
挥动	otes
索取	otey
挥舞	otfc
索引	otga
探求	othg
屠杀	otih
索	otja
挂钩	otjd
持续	otjo
摞	otjt
社员	otkb
挂号	otkh
探听	otkj
探亲	otlh
探矿	otog
砝码	otom
探索	otot
拷	otpg
胡思乱想	otpm
屠	otpr
挂念	otrd
社会	otre
拥军优属	otro
探测	otsb
祛	otsd
砝	otsh
磕	otsm
挂帅	otsp
硅	otth
挂	ottt
挥	otvt
持球	otwh
撂	otwk
挥发	otwp
直截了当	otwx
崽	otxa
勃然	otxd
索性	otxf
探讨	otyc
社论	otyr
硅酸	otys
孛	otza
勃	otzl
鹁	otzn
有	ou
有些	ouab
有点	ouah
拥	ouat
攉	ouat
有的	oubd
有关	oube
有益	oubh
有数	oubm
按需分配	ouby
有若	ouco
有色	oudb
有为	oudl
有效	oueb
有限	ouei
郁	ouep
有功	ougl
有事	ouhk
有错	oujc
有钱	ouje
有线	ouje
有力	oulg
有意	oulr
有机	oumj
郁闷	oumx
有如	ounk
拥抱	ouod
拥护	ouod
拥有	ouou
拥挤	ouow
有	ouph
有利	oupm
有种	oupm
有所	oupp
有待	oupr
有时	ourc
有余	oure
撸	ourt
崩溃	ousk
崩塌	outr
擂	outt
崩	ouua
有用	ouua
硼	ouuh
有成	ouvg
有理	ouwr
有心	ouxd
有家	ouxh
有名	ouxk
有害	ouxs
有着	ouym
有趣	ouze
碱	ov
撅	ovbq
振荡	ovcs
振兴	ovdb
振奋	ovdt
岸	ovea
振	oven
振动	oves
碱度	ovgc
蚀	ovgd
扼	ovgg
砗	ovha
碱	ovhd
崴	ovhd
砺	ovhg
打成一片	ovhp
撼	ovhx
扼杀	ovih
崭	ovja
振幅	ovjh
崭新	ovlh
岸边	ovlz
扬长避短	ovof
振作	ovrf
崖	ovtt
捱	ovtt
碱性	ovxf
扼要	ovxn
峰	ow
嵋	owam
础	owao
屈	owao
拙	owao
揆	owdd
嶝	owdd
磴	owdd
抒	owdg
揉	owdm
捅	owdo
抉	owdt
碌	owen
禄	owen
扭动	owes
撖	owew
喜出望外	owex
扭矩	owfd
牛皮	owgp
抿	owhg
岷	owhg
拯救	owhg
尸	owhp
牛顿	owhw
层出不穷	owhx
扭曲	owkc
硌	owkh
拨号	owkh
擢	owla
摺	owlb
牛马	owmw
牛奶	owng
揉捻	owor
拨款	owos
有条有理	owow
抉择	owoy
挤	owpa
拨	owpd
尸体	owrm
峰	owsa
拯	owsh
拗	owsl
牛	owtt
扭	owtt
屈服	owue
扭转	owve
屈辱	owve
挤压	owvt
掼	owwb
拨弄	owwc
掾	owwn
抒发	owwp
拶	owwx
抒情	owxh
岁	oxad
抄送	oxbe
砣	oxbh
砂糖	oxbm
岁数	oxbm
崇敬	oxcd
挖苦	oxco
按期	oxcs
刿	oxda
南宁市	oxej
擦亮	oxek
崇高	oxek
摈除	oxer
摈弃	oxes
控告	oxfa
控制	oxfh
崆	oxga
石家庄市	oxge
控	oxgt
挖	oxgt
石家庄	oxgt
按下	oxha
矽	oxhd
拧	oxhg
硒	oxhh
揎	oxhh
碹	oxhh
磔	oxhm
碇	oxhr
挡	oxit
撺	oxka
挡路	oxka
撇开	oxkh
躺	oxkk
提心吊胆	oxku
撇	oxkw
砂浆	oxla
抄本	oxmh
挡板	oxmp
崾	oxna
按	oxnt
崇	oxoa
崇祯	oxoa
抄报	oxoe
抄袭	oxog
擦拭	oxoh
峭壁	oxok
挖掘	oxoo
摈	oxpb
镔	oxpb
崇拜	oxpe
砂	oxph
研究所	oxpp
抄	oxpt
按时	oxrc
按照	oxrd
撑住	oxre
擦伤	oxrf
身心健康	oxrg
硝化	oxrq
山穷水尽	oxso
推心置腹	oxsu
崇洋	oxsy
抄写	oxth
砂土	oxth
撑	oxto
峭	oxua
硝	oxuh
屑	oxup
岁月	oxup
手忙脚乱	oxup
捎	oxut
砂轮	oxvr
挖出	oxwa
抄录	oxwe
馆	oxwh
碗	oxxg
研究室	oxxh
崇尚	oxxk
擦	oxxo
山西省	oxxp
控诉	oxyj
硝酸	oxys
支	oy
支点	oyah
支	oyan
摊	oyat
友爱	oyat
祥	oyda
搔	oydv
择	oyea
峄	oyea
磋商	oyeb
支队	oyer
嵯	oyga
磋	oygh
翅	oygl
搓	oygt
支部	oylk
支架	oylk
支柱	oyme
友好	oynz
支援	oyoa
献计献策	oyoa
尽善尽美	oyob
支持	oyot
支撑	oyox
支委	oypm
友	oypn
支付	oyrc
友人	oyrp
支流	oyse
摊派	oysp
支农	oyti
翅膀	oyue
支出	oywa
支书	oywg
馐	oywt
友情	oyxh
支票	oyxo
支配	oyyj
搡	oyym
磉	oyym
友谊	oyyx
掇	oyyy
羼	oyyy
孱	ozzz
段	pa
川	paa
顺	paab
片断	pabm
段落	pacs
延期	pacs
兵变	paea
盥	paem
丘陵	paet
片刻	paew
丘	pag
兵	pagb
乓	pagd
邱	page
岳	pago
乒	pagp
顺序	pagw
牍	pahd
待业青年	pahf
自上而下	pahh
牒	pahm
牌	paho
版面	pahp
片面	pahp
千篇一律	pahp
版画	paht
片	pahw
版	pahy
延缓	paja
顺风	paji
延续	pajo
顺口	paka
顺路	paka
兵团	pakh
牌号	pakh
兵器	pakk
版图	pakw
兵力	palg
顺次	palq
版本	pamh
版权	pamy
兵权	pamy
延迟	paod
顺手	paop
片段	papa
乒乓	papa
兵种	papm
顺利	papm
兵役	papr
顺便	parh
顺从	parr
延伸	parr
川江	pasg
顺治	pass
段	pasy
延长	pavp
顺当	paxi
延安	paxn
延误	payk
顺着	paym
延	paz
牌子	pazw
片子	pazw
翻	pb
番茄	pbcl
翻动	pbes
释放	pbfw
乎	pbhg
翻阅	pbmb
鄱	pbme
釉	pbmh
翻	pbml
释	pbmo
番	pbmt
悉	pbmx
翻身	pbop
翻印	pbpg
翻滚	pbse
翻腾	pbub
翻转	pbve
自尊心	pbxd
翻案	pbxn
翻译	pbyy
升	pc
升	pca
升学	pcdb
升高	pcek
升降	pcew
反过来说	pchy
升级	pcjp
后勤部	pclk
乔	pd
科学管理	pdaw
科学分析	pdbm
貊	pddb
貔	pddb
豹	pddd
貘	pddd
貌	pdde
貉	pddk
貂	pddk
貅	pddm
豺	pddp
豸	pddp
邈	pddz
科学院	pdex
留学生	pdft
自负盈亏	pdge
迎刃而解	pdhd
千头万绪	pdhj
乔木	pdmh
夭	pdn
岙	pdo
行之有效	pdoe
科学技术	pdom
垂头丧气	pdoq
科学研究	pdox
乔	pdpa
昏头昏脑	pdpu
豺狼	pdqd
乏	pdwn
科学家	pdxh
豹子	pdzw
看	pe
看上	peah
瓜熟蒂落	pecc
看过	pecz
看望	peeg
拜年	pefh
翻天复地	peft
看病	pegl
看来	pehb
千变万化	pehr
看到	pehs
看中	peka
看见	pekp
自动检索	pemo
自动检测	pems
看护	peod
自动控制	peof
看看	pepe
看重	peph
看	pepm
拜	pepo
掰	pepo
搿	pepo
看待	pepr
拜会	pere
奥运会	pere
看做	pero
自动化	perq
看法	pest
看成	pevg
看出	pewa
看齐	pewp
看守	pexc
拜访	peyf
自告奋勇	pfdw
千方百计	pfhy
九	pg
重工业	pgaa
迎战	pgah
雕塑	pgbh
馗	pgbm
昏迷	pgbm
印花	pgcr
杂草	pgcr
周期	pgcs
丸	pgd
贸	pgdb
留学	pgdb
卵	pgdd
袅	pgdi
凫	pgdj
印象	pgdk
岛	pgdo
留	pgdt
孵	pgdz
遛	pgdz
丹	pge
留恋	pgea
周刊	pgea
杂交	pgeb
彤	pgep
删除	pger
乌云	pges
雕刻	pgew
迎	pgez
氏族	pgff
周旋	pgff
周年	pgfh
印度	pggc
邬	pgge
乌	pggh
氐	pghd
印	pghe
邸	pghe
氏	pghg
周末	pghm
鸱	pghn
迎面	pghp
昏	pghr
周到	pghs
丹麦	pght
乌鸦	pghw
杂	pghx
迎风	pgji
留级	pgjp
留给	pgjr
删改	pgjw
乌黑	pgkb
循序见进	pgke
周围	pgkh
杂品	pgkk
瞧见	pgkp
留意	pglr
印章	pglr
鸠	pgn
杂物	pgnd
周报	pgoe
程序控制	pgof
九龙	pgog
岛屿	pgoh
杂志	pgoh
印刷	pgoj
周折	pgoj
迎接	pgol
杂技	pgoo
周身	pgop
留神	pgor
周岁	pgox
删	pgpd
卯	pgpe
瞧	pgpe
册	pgph
杂种	pgpm
杂乱	pgpo
杂质	pgpp
旭	pgr
旮	pgr
留念	pgrd
贸易	pgrd
迎合	pgrh
反革命	pgrh
昏暗	pgrl
孵化	pgrq
杂货	pgrq
九江	pgsg
印染	pgsp
昏沉	pgst
印度洋	pgsy
雕	pgta
周	pgtk
九月	pgup
周转	pgve
周长	pgvp
杂务	pgwl
印发	pgwp
卵巢	pgww
尔	pgx
玺	pgxd
丹心	pgxd
留心	pgxd
周密	pgxd
留情	pgxh
迩	pgxz
留言	pgyd
程序设计	pgyy
册子	pgzw
重	ph
重点	phah
行政管理	phaw
秉公	phbs
和平共处	phcw
重大	phdh
重复	phfr
重庆	phgd
适可而止	phha
自下而上	phha
千百万	phhp
行政区域	phht
秘而不宣	phhx
秉	phib
重建	phie
微不足道	phkb
重型	phkd
熏	phkh
重力	phlg
重新	phlh
重物	phnd
重视	phok
重担	phor
重重	phph
重申	phra
得不偿失	phrf
重合	phrh
重量	phrh
重任	phrp
系列化	phrq
重	phrt
重油	phsk
重地	phtg
重用	phua
重心	phxd
重要	phxn
翻来覆去	phxt
重叠	phyy
系	pj
币	pja
系数	pjbm
系	pjd
系统工程	pjgp
千锤百炼	pjhh
千钧一发	pjhw
系列	pjhx
系统	pjje
后继有人	pjor
向	pk
向北	pkae
向上	pkah
奥	pkbd
粤	pkbg
兵器工业部	pkgl
向下	pkha
向来	pkhb
向东	pkhw
向	pkk
禹	pkkd
微型机	pkmj
奥妙	pknx
向左	pkog
向右	pkok
奥秘	pkpm
向后	pkpp
向往	pkpr
委员会	pkre
向量	pkrh
向导	pksc
委员长	pkvp
囱	pkwh
囟	pkwh
向西	pkxh
向着	pkym
逃	pl
脊背	plae
逃亡	plew
兆	plgd
鼗	plgy
逃	plgz
自力更生	plhf
逃跑	plka
逃避	plok
脊	plpu
逃命	plrh
兆赫	pltp
逃脱	plub
逃窜	plxk
逃走	plzh
和	pm
稚	pma
稳步	pmaa
稻	pmaj
稳妥	pman
牖	pmao
自筹	pmas
血管	pmax
稃	pmaz
秕	pmbb
积分	pmbd
税	pmbe
科普	pmbh
利益	pmbh
自首	pmbh
和数	pmbm
香料	pmbm
种类	pmbm
稗	pmbo
衅	pmbo
穆	pmbp
自白	pmbp
自卑	pmbp
稻谷	pmbr
自尊	pmby
香蕉	pmca
积蓄	pmce
季节	pmcg
香菇	pmcn
愁苦	pmco
稻草	pmcr
种花	pmcr
利落	pmcs
稀薄	pmcs
私营	pmct
和蔼	pmcy
透过	pmcz
利	pmd
科举	pmdb
科学	pmdb
秋色	pmdb
血色	pmdb
自负	pmdb
自觉	pmdb
自学	pmdb
黎	pmdd
秘	pmdd
黧	pmdh
稍为	pmdl
梨	pmdm
犁	pmdn
稂	pmdn
科	pmdo
和解	pmdu
稳	pmdx
秆	pmea
移交	pmeb
利于	pmeg
穰	pmei
稿	pmek
自豪	pmek
血迹	pmep
秋天	pmer
移动	pmes
自动	pmes
自主	pmet
利率	pmew
税率	pmew
积聚	pmey
称赞	pmfa
秩	pmfd
种族	pmff
自制	pmfh
秋收	pmga
税收	pmga
自卫	pmga
程度	pmgc
季度	pmgc
黏度	pmgc
和弦	pmge
自习	pmgl
秀	pmgp
稿费	pmgp
自费	pmgp
程序	pmgw
秩序	pmgw
透	pmgz
秋	pmh
血	pmh
自	pmh
和平	pmhb
秃顶	pmhg
秀才	pmhg
香烟	pmhk
秀丽	pmhk
秧歌	pmhk
秣	pmhm
秤	pmho
愁	pmhx
穗	pmhx
自燃	pmhx
自杀	pmih
稀	pmij
种群	pmik
秃	pmj
颓	pmjb
和约	pmjd
和风	pmji
季风	pmji
秋风	pmji
透风	pmji
黏结	pmjo
稿纸	pmjp
税金	pmjp
租金	pmjp
自给	pmjr
血缘	pmjw
自己	pmjw
和	pmk
种	pmka
积	pmkb
科员	pmkb
委员	pmkb
秧	pmkd
血型	pmkd
香味	pmke
称号	pmkh
稆	pmkk
稳固	pmko
自由	pmko
称呼	pmkp
血肉	pmkr
租	pmks
程	pmkw
自立	pmld
自力	pmlg
和亲	pmlh
自决	pmlw
臬	pmm
科目	pmma
秫	pmmd
自述	pmmd
自问	pmmk
移植	pmmo
种植	pmmo
积极	pmmp
刮目相看	pmmp
血栓	pmmr
和睦	pmmt
愁闷	pmmx
禾	pmn
委	pmn
自如	pmnk
魏	pmns
逶	pmnz
和好	pmnz
积存	pmoa
自在	pmoa
稹	pmob
禾苗	pmoc
透射	pmoc
秧苗	pmoc
和局	pmog
穑	pmoh
和声	pmoh
秸	pmok
科研	pmok
透视	pmok
自古	pmok
科协	pmol
嵇	pmoo
科技	pmoo
自居	pmoo
委托	pmop
稀饭	pmop
自身	pmop
稽	pmor
利索	pmot
私有	pmou
稀有	pmou
委屈	pmow
秽	pmox
稀释	pmpb
稠	pmpg
稳重	pmph
自重	pmph
稻种	pmpm
科委	pmpm
利息	pmpm
秋季	pmpm
稍稍	pmpm
私利	pmpm
私自	pmpm
种种	pmpm
自称	pmpm
自私	pmpm
租税	pmpm
自我	pmpo
秭	pmpp
秋后	pmpp
稍微	pmpr
透彻	pmpr
称	pmpx
臭	pmq
和气	pmqp
透气	pmqp
香气	pmqp
稚气	pmqp
香	pmr
自修	pmra
租借	pmrc
黍	pmrd
和会	pmre
自传	pmre
稳健	pmri
黏	pmrk
稞	pmrm
稿件	pmrn
私人	pmrp
委任	pmrp
租赁	pmrp
自从	pmrr
黎明	pmru
透明	pmru
馥	pmrw
稔	pmrx
自信	pmry
私	pms
秋耕	pmsa
鼻涕	pmsb
香港	pmsc
自满	pmsc
血汗	pmse
血液	pmse
自流	pmse
黏液	pmse
积水	pmsg
血清	pmsh
香油	pmsk
利润	pmsm
自治	pmss
鼻	pmta
稻田	pmta
秧田	pmta
种田	pmta
劓	pmtd
鼽	pmtg
种地	pmtg
齄	pmth
黏土	pmth
积累	pmtj
移栽	pmtm
鼾	pmto
自封	pmtt
稷	pmtw
利用	pmua
自用	pmua
租用	pmua
黏膜	pmuc
称霸	pmug
积雪	pmui
透露	pmuk
秘鲁	pmur
血腥	pmur
自愿	pmvb
自转	pmve
科长	pmvp
积压	pmvt
血压	pmvt
稀疏	pmwa
秘书	pmwg
移民	pmwh
税务	pmwl
自发	pmwp
衄	pmwt
息	pmx
稠密	pmxd
秘密	pmxd
私心	pmxd
颓然	pmxd
自然	pmxd
黏性	pmxf
积极性	pmxf
科室	pmxh
稳定	pmxh
自家	pmxh
稳当	pmxi
和尚	pmxk
利弊	pmxk
稼	pmxn
秒	pmxp
稀少	pmxp
愁容	pmxr
利害	pmxs
稍	pmxu
移	pmxx
和谐	pmyb
种差	pmyg
秘诀	pmyw
季	pmz
鼻孔	pmzg
鼻子	pmzw
稻子	pmzw
稿子	pmzw
种子	pmzw
入	pn
籴	pnbm
入学	pndb
入库	pngv
自始至终	pnhj
入口	pnka
入睡	pnmp
入射	pnoc
入手	pnop
入神	pnor
入时	pnrc
入侵	pnri
汆	pns
入场	pntg
入土	pnth
入党	pnxt
我	po
千	poa
乘	poab
乖	poab
剩	poad
乘虚	poah
千卡	poah
乘船	poaj
乘数	pobm
千米	pobm
甜菜	poca
垂	poch
舌头	podd
垂危	podv
适于	poeg
辞职	poek
迁就	poek
私有制	pofh
所有制	pofh
适度	pogc
我	pogd
适应	pogd
自古以来	pogh
鹅	pogn
壬	poh
剩下	poha
千瓦	pohg
千真万确	poho
千万	pohp
垂死	pohx
廷	pohz
辞退	poig
垂线	poje
歃	pojq
舌	pok
垂足	poka
适中	poka
刮	pokd
舔	pokd
甜	poke
甜味	poke
乱	pokg
舐	pokg
鸹	pokn
辞	poko
敌	pokw
我国	pokw
憩	pokx
适	pokz
乘机	pomj
垂直	pook
敌视	pook
千克	pook
千升	popc
乘积	popm
迁移	popm
适时	porc
剩余	pore
适合	porh
适量	porh
科技人员	pork
垂体	porm
我们	porm
印刷体	porm
敌人	porp
留有余地	port
乘法	post
所有者权益	potb
千赫	potp
迁都	potp
辞去	pots
敌军	potv
我军	potv
适用	poua
乘胜	pouf
乘车	povh
科研成果	povr
甜蜜	poxd
适当	poxi
适宜	poxk
我党	poxt
乘客	poxw
敌对	poyc
迁	poz
丿	pp
返航	ppae
质点	ppah
反比	ppbb
瓜分	ppbd
后半	ppbe
后勤	ppch
后世	ppch
殷勤	ppch
后期	ppcs
后头	ppdd
反之	ppdw
质变	ppea
反帝	ppeb
反击	ppeo
后进	ppep
所向无敌	ppep
后天	pper
反动	ppes
后方	ppfd
须知	ppfd
反复	ppfr
后生	ppft
后卫	ppga
瓞	ppgd
反应	ppgd
所以	ppgd
瓜	ppgn
反攻	ppgw
反正	ppha
后来	pphb
顺息万变	pphe
卮	pphg
后	pphk
反而	pphp
反面	pphp
后面	pphp
逅	pphz
后退	ppig
殷	ppiy
后续	ppjo
返销	ppjx
返回	ppkk
反响	ppkp
后边	pplz
质朴	ppma
后门	ppmd
反驳	ppmi
反问	ppmk
质问	ppmk
反扑	ppoa
所在	ppoa
质	ppob
反射	ppoc
反抗	ppoe
反馈	ppok
殷克	ppok
盾	ppom
反手	ppop
后手	ppop
所属	ppop
所有	ppou
自我批评	ppoy
遁	ppoz
彡	ppp
须	pppb
反向	pppk
所得	pppr
反修	ppra
后代	pprh
质量	pprh
反映	pprk
瓜果	pprm
后果	pprm
后人	pprp
后台	ppsk
反演	ppsx
质地	pptg
后者	pptp
反霸	ppug
后肢	ppuo
反转	ppve
反感	ppvh
自行车	ppvh
所长	ppvp
所	ppwj
后备	ppwt
反悔	ppxf
后悔	ppxf
反光	ppxh
须要	ppxn
反常	ppxt
反	ppy
反对	ppyc
反差	ppyg
反醒	ppyr
所谓	ppyt
返	ppyz
瓜子	ppzw
质子	ppzw
乇	pqg
得	pr
彳	pra
待业	praa
行业	praa
彼此	prab
徭	praf
征集	pram
律师	prap
微笑	prap
徙	prar
徘	pras
质量管理	praw
得分	prbd
微分	prbd
征购	prbd
徒弟	prbg
街道	prbh
微粒	prbm
微米	prbm
稀里糊涂	prbs
徨	prbw
徼	prbw
徒劳	prct
街头	prdd
很大	prdh
行为	prdl
徐州	prdp
徇	prdr
行	preg
行进	prep
彻夜	prer
德育	pres
行动	pres
往	pret
贸易市场	pret
得失	prfd
得知	prfd
御	prfe
往年	prfh
往复	prfr
征收	prga
微弱	prgl
彻底	prgp
彼	prgy
征	prha
行政	prha
徕	prhb
往来	prhb
行医	prhf
衙	prhg
得救	prhg
征求	prhg
往事	prhk
行事	prhk
得到	prhs
惩	prhx
行列	prhx
很	prin
律	prio
衔	prjg
微风	prji
微细	prjt
役	prjy
徒刑	prkd
微型	prkd
徊	prkh
徂	prks
德国	prkw
得逞	prkw
得奖	prla
惩办	prlb
得力	prlg
得意	prlr
衙门	prmd
衢	prmg
待机	prmj
微机	prmj
行驶	prmk
待查	prmr
行李	prmz
待物	prnd
很好	prnz
行礼	prog
衔接	prol
待人接物	pron
徒手	prop
徽	prow
微	prow
徵	prow
德	prox
贸易协定	prox
所作所为	prpd
径向	prpk
循	prpm
行程	prpm
征稿	prpm
征税	prpm
往返	prpp
往后	prpp
德行	prpr
徘徊	prpr
往往	prpr
微微	prpr
行径	prpr
徐徐	prpr
征得	prpr
徭役	prpr
彻	prqd
往日	prra
得	prrc
征途	prre
行星	prrf
衡量	prrh
微量	prrh
行使	prrh
待遇	prrk
得体	prrm
行人	prrp
徐	prrx
得罪	prsa
衍	prsg
微波	prsg
惩治	prss
愆	prsx
惩罚	prsy
待	prtc
街	prtg
行军	prtv
征服	prue
得胜	pruf
衡	prug
行车	prvh
微软	prvq
惩处	prwa
得出	prwa
径	prwg
循环	prwh
後	prww
很小	prxg
微小	prxg
径赛	prxh
行家	prxh
行情	prxh
御寒	prxh
得当	prxi
徜	prxk
很少	prxp
往常	prxt
待客	prxw
很多	prxx
徉	pry
微观	pryk
徒	prz
行走	przh
么	ps
么	psd
自治区	pshi
顺水推舟	psoa
睾丸	pspg
睾	psto
丢	pt
丢失	ptfd
丢掉	ptoa
丢人	ptrp
丢	pts
丢脸	ptur
乌鲁木齐市	pume
乌鲁木齐	pumw
后顾之忧	pvdx
及	pw
及其	pwcs
乐句	pwdk
枭	pwdm
乐于	pweg
追击	pweo
追随	pweo
乐队	pwer
追求	pwhg
阜	pwho
追逐	pwhp
及至	pwhs
追	pwhz
追踪	pwka
乐曲	pwkc
乐园	pwke
乐器	pwkk
追加	pwlk
乐意	pwlr
乐章	pwlr
追问	pwmk
追查	pwmr
及格	pwmw
及	pwn
乐段	pwpa
及时	pwrc
及早	pwro
胤	pwsg
追肥	pwub
秘书长	pwvp
微处理机	pwwm
乐	pwx
追悼	pwxa
追究	pwxp
乐观	pwyk
乐趣	pwze
追赶	pwze
自然科学	pxpd
积少成多	pxvx
重要性	pxxf
去	q
狮	qa
狮	qapj
狮子	qazw
氛	qb
狴	qbbt
氛	qbdg
狈	qbpd
猫	qc
猎取	qcey
猎	qchr
獾	qcka
猎物	qcnd
猎人	qcrp
猫	qctp
切	qd
切点	qdah
切断	qdbm
獠	qdbx
切除	qder
切	qdgp
猗	qdhg
狰	qdig
狼	qdin
切线	qdje
切忌	qdjx
切口	qdka
切开	qdkh
狗	qdkp
切身	qdop
切片	qdpa
狼狈	qdqb
气象台	qdsk
狍	qdsp
獬	qdun
切实	qdxd
切割	qdxs
切削	qdxu
氦	qe
犴	qeap
狡	qebi
狡猾	qeqk
猝	qero
氦	qewr
犯	qg
犯规	qger
犯	qggp
氟	qgpa
狒	qgpa
氖	qgpg
犷	qgpp
猕	qgpx
犯人	qgrp
犯罪	qgsa
犯法	qgst
七	qh
氩	qhah
狭	qhbd
猜疑	qhbf
狭义	qhdi
狭隘	qheb
七	qhg
氮	qhhg
七一	qhhh
獭	qhkb
猜想	qhmm
狨	qhod
狄	qhpn
犬	qhpn
氮气	qhqp
氰化	qhrq
猜测	qhsb
猜	qhtu
氰	qhtu
氮肥	qhub
七月	qhup
狭长	qhvp
狭窄	qhxf
狭小	qhxg
猜谜	qhyb
逖	qhzp
狠	qi
狠	qign
狠毒	qiht
狠狠	qiqi
狠心	qixd
猊	qjep
狂风暴雨	qjru
猾	qk
氤	qkdh
狭路相逢	qkmw
狙	qksp
猾	qkwu
獍	qlre
獐	qlro
犸	qmph
猹	qmrh
犹	qo
七手八脚	qobu
氙	qoga
犹	qogd
氪	qoke
猢	qoku
犹如	qonk
切身利益	qopb
气势汹汹	qoss
犹豫	qowd
气	qp
氚	qpaa
氘	qpag
气管	qpax
气魄	qpbb
气节	qpcg
气色	qpdb
气态	qpdd
气象	qpdk
气动	qpes
氕	qpg
欠	qpgp
犭	qpgp
犰	qpgp
气焰	qphd
气	qphh
獯	qphh
气味	qpke
气喘	qpko
气力	qplg
猁	qpmd
气门	qpmd
气概	qpmi
气阀	qpmr
气馁	qpoa
气垫	qpop
气势	qpop
气息	qppm
狐	qppn
气质	qppp
气氛	qpqb
狐狸	qpqr
气候	qpra
气量	qprh
气体	qprm
气化	qprq
气泡	qpsd
气流	qpse
气派	qpsp
气温	qpsr
气压	qpvt
气球	qpwh
气恼	qpxe
气愤	qpxo
气孔	qpzg
狼狈不堪	qqht
飙	qqqi
猴	qr
狎	qrap
猞	qrek
狯	qres
狳	qrex
猩	qrft
猃	qrhh
氲	qrmg
猓	qrmp
猩猩	qrqr
猖獗	qrqv
猖狂	qrqw
猖	qrrp
狸	qrtp
狷	qrup
猴	qrwd
猴子	qrzw
狻	qsbw
狁	qsep
猡	qsxp
猪	qt
猥	qthn
猿	qtki
猪肉	qtkr
橥	qtpm
猪	qtpr
猬	qtup
独	qv
独占	qvah
独白	qvbp
獗	qvbq
独立	qvld
独特	qvnt
独	qvpd
独自	qvpm
独创	qvrg
独裁	qvti
氢	qw
猸	qwam
氡	qwdd
氢	qwdg
猱	qwdm
氯	qwed
狂妄	qwew
氢弹	qwgb
狂风	qwji
狂喜	qwod
狂热	qwop
狂	qwph
氯气	qwqp
氢气	qwqp
狃	qwtp
逛	qwzp
氨	qx
狞笑	qxap
狩	qxcp
氨基	qxcs
狞	qxhg
猛烈	qxhx
猛冲	qxlk
猛	qxmp
氨	qxng
氨水	qxsg
猛然	qxxd
氧	qy
氧	qyga
狺	qyph
狱	qyqp
氧气	qyqp
氧化	qyrq
猛	qz
狲	qzxp
人	r
日	ra
企业	raaa
修筑	raag
显	raah
企业管理	raaw
日前	rabh
日益	rabh
修剪	rabh
修养	rabs
甲苯	racm
日期	racs
显著	ract
仆	rada
悠久	radn
日元	raee
个儿	raep
日夜	raer
暖	raey
候选	rafa
修造	rafa
甲方	rafd
修复	rafr
甲乙	ragg
畅	ragp
甲	rah
申	rah
僬	raha
日下	raha
修正	raha
侦	rahb
佧	rahd
修整	rahk
倬	raho
日至	rahs
甲烷	rahx
候补	raia
修补	raia
修建	raie
修改	rajw
畅销	rajx
修缮	rajy
日中	raka
个别	rakl
企图	rakw
日新	ralh
日本	ramh
显眼	rami
畅想	ramm
甲板	ramp
侦查	ramr
个	ran
企	ranh
鸭	ranh
修好	ranz
日报	raoe
修饰	raof
悠扬	raog
显示	raoh
侦探	raot
暖和	rapm
日程	rapm
日后	rapp
显得	rapr
暖气	raqp
日照	rard
显影	rare
暧昧	rare
个位	rarl
个体	rarm
个人	rarp
申明	raru
暖流	rase
畅游	rasf
俳	rass
日渐	rasv
暧	raty
日用	raua
显露	rauk
日月	raup
候车	ravh
修长	ravp
攸	rawa
日出	rawa
候	rawd
畅通	rawd
日	rawh
曰	rawh
显现	rawk
修	rawp
倏	rawq
修理	rawr
悠	rawx
显然	raxd
个性	raxf
日光	raxh
日常	raxt
畅快	raxw
侦察	raxx
甲醛	rayc
甲醇	raye
申请	rayh
修订	rayh
日记	rayj
申诉	rayj
修配	rayj
甲酸	rays
俘	raza
日趋	razd
暹	razh
个子	razw
日子	razw
鸭子	razw
侧	rb
伯	rbah
仳	rbba
偕	rbbb
倾盆	rbbd
昆	rbbh
伯父	rbbi
侧	rbda
份	rbda
化公为私	rbdp
倾角	rbdu
伴	rbea
倦	rbeg
侧耳	rbeh
伴随	rbeo
倾	rbhb
侧面	rbhp
倾听	rbkj
僧	rbkr
偻	rbmn
伯母	rbmw
仑	rbng
伞	rbon
侧重	rbph
倾向	rbpk
俾	rbpo
傀	rbps
伯伯	rbrb
倾斜	rbre
倾倒	rbrh
俗	rbrk
伴侣	rbrk
僧侣	rbrk
傀儡	rbrt
昆明	rbru
倾注	rbse
伴奏	rbsr
倾泻	rbst
佾	rbua
昆虫	rbva
曦	rbwd
份额	rbxw
侧记	rbyj
俗话	rbyp
时	rc
借鉴	rcaa
付	rcad
时分	rcbd
供养	rcbs
时节	rccg
时期	rccs
儆	rcdw
时效	rceb
暴动	rces
时刻	rcew
借方	rcfd
供应	rcgd
借以	rcgd
供	rchb
暴	rchd
时	rchd
供求	rchg
时事	rchk
时而	rchp
借	rchr
暴君	rcik
暴风	rcji
时钟	rcjk
时针	rcjo
供给	rcjr
供销	rcjx
暴躁	rcka
借口	rcka
借助	rcks
暴力	rclg
时机	rcmj
时间	rcmr
时报	rcoe
时局	rcog
偌	rcok
借款	rcos
暴徒	rcpr
暴行	rcpr
时候	rcra
时时	rcrc
供电	rcrg
时代	rcrh
任劳任怨	rcrx
全世界	rctr
借用	rcua
暴雨	rcuh
暴露	rcuk
时辰	rcve
付出	rcwa
暴发	rcwp
时光	rcxh
时常	rcxt
领	rd
晚餐	rdah
晚上	rdah
含笑	rdap
照旧	rdar
含糊	rdbm
照料	rdbm
僚	rdbx
领带	rdca
含蓄	rdce
晚期	rdcs
仞	rdda
领头	rddd
念头	rddd
仪态	rddd
含义	rddi
偏远	rdee
侉	rdeg
易于	rdeg
偏离	rdei
今天	rder
领队	rder
日久天长	rdev
领取	rdey
领先	rdfa
伪造	rdfa
倚靠	rdfa
今年	rdfh
晚年	rdfh
照度	rdgc
照应	rdgd
化学工业部	rdgl
倚	rdhg
仪式	rdhg
领事	rdhk
仪表	rdht
仪	rdia
领袖	rdik
偏袒	rdir
佝	rdka
冕	rdkg
晚	rdkg
昭	rdkh
照	rdkh
煦	rdkh
仪器	rdkk
像	rdkn
偏见	rdkp
邻国	rdkw
贪图	rdkw
伪装	rdla
照办	rdlb
伪	rdld
昀	rdlh
贪婪	rdmm
照相	rdmm
晚间	rdmr
照样	rdmy
偏	rdoc
照射	rdoc
晚报	rdoe
邻居	rdoo
晚饭	rdop
像片	rdpa
照片	rdpa
剔	rdpd
照看	rdpe
偏重	rdph
偏向	rdpk
晚稻	rdpm
歇息	rdpm
易	rdpp
今后	rdpp
偬	rdpx
今日	rdra
今晚	rdrd
偏偏	rdrd
领会	rdre
晚会	rdre
照会	rdre
俺	rdrg
含量	rdrh
照例	rdrh
俺们	rdrm
偏僻	rdro
令人	rdrp
歇	rdrq
照明	rdru
曷	rdrw
遏	rdrz
偏激	rdsb
领导	rdsc
贪污	rdse
领海	rdsf
含水	rdsg
含混	rdsr
领土	rdth
领域	rdth
伪军	rdtv
昭雪	rdui
晚霞	rduw
偏转	rdve
照顾	rdvg
偏压	rdvt
人之长情	rdvx
儋	rdvy
领	rdwb
贪	rdwb
颔	rdwb
令	rdwd
瓴	rdwd
邻	rdwe
念书	rdwg
衾	rdwi
含	rdwk
翎	rdwl
今	rdwn
念	rdwx
偏心	rdxd
领空	rdxg
领悟	rdxh
照耀	rdxh
照常	rdxt
偏差	rdyg
伪证	rdyh
照着	rdym
会	re
停业	reaa
停止	reaa
昧	reab
倪	reag
舒	reag
旱	reah
仁	reah
佴	reah
旰	reah
停战	reah
舍	reak
会师	reap
传送	rebe
傍	rebf
传递	rebg
佼	rebi
余粮	rebm
余数	rebm
传单	rebr
景色	redb
传奇	redh
最大	redh
景象	redk
影象	redk
最为	redl
传遍	redo
住房	redo
传达	redz
晾干	reea
会商	reeb
体育运动	reee
最高	reek
传动	rees
斜率	reew
住院	reex
最先	refa
余年	refh
停放	refw
斜度	regc
余弦	rege
停工	regh
舒张	regv
余下	reha
传来	rehb
停火	rehd
叙事	rehk
会面	rehp
斜面	rehp
景致	rehs
停顿	rehw
最初	reid
禽	reis
伉	reja
传统	reje
斜线	reje
体育锻炼	rejh
斜纹	rejw
最终	rejw
最近	rejz
途中	reka
颢	rekb
会员	rekb
僦	rekd
仁兄	reke
停	rekg
会同	rekh
曩	reki
影	rekp
会见	rekp
影响	rekp
暾	rekw
景	rekx
晾	rekx
最新	relh
停产	relp
会意	relr
斜边	relz
叙述	remd
电动机	remj
佞	rena
景物	rend
最好	renz
传授	reoa
舒展	reoc
影射	reoc
传真	reok
传播	reop
传热	reop
余热	reop
影片	repa
停留	repg
影印	repg
停息	repm
舒适	repo
住所	repp
最后	repp
途径	repr
舒畅	rera
傍晚	rerd
影像	rerd
昊	rerh
传题	rerh
会合	rerh
会晤	rerh
最低	rerp
最佳	rert
停泊	resb
传导	resc
停滞	resc
刽	resd
郐	rese
昙	resh
会	resn
传染	resp
住	reta
住址	reta
蛀	retd
旱地	retg
会场	retg
斜坡	retg
余地	retg
最坏	reth
舒坦	retr
舒服	reue
停车	revh
传输	revr
住处	rewa
传	rewd
旱灾	rexh
余	rexn
斜	rexo
住宅	rexp
最少	rexp
住宿	rexr
会堂	rext
会客	rexw
余额	rexw
叙	rexy
途	rexz
传说	reyb
叙说	reyb
会议	reyd
最	reyh
会谈	reyh
会计	reyo
会话	reyp
影子	rezw
作	rf
作业	rfaa
昨	rfae
作	rfae
仿	rfag
作战	rfah
星期	rfcs
佚	rfda
星斗	rfdd
作为	rfdl
昨天	rfer
昨夜	rfer
作主	rfet
伤亡	rfew
仿造	rffa
仿制	rffh
仡	rfga
伤疤	rfgl
伤痕	rfgl
伤痛	rfgl
星座	rfgr
作废	rfgw
体制改革	rfjg
伤风	rfji
作风	rfji
伤口	rfka
伤员	rfkb
作品	rfkk
伤	rfla
侮	rfma
晦	rfmh
作物	rfnd
仵	rfoa
仿真	rfok
伤势	rfop
明知故犯	rfoq
伤兵	rfpa
作息	rfpm
作伴	rfrb
仿照	rfrd
昨晚	rfrd
星星	rfrf
仿佛	rfrg
作法	rfst
作坊	rftf
戥	rftg
星	rfth
作者	rftp
作用	rfua
侮辱	rfve
作成	rfvg
伤感	rfvh
作文	rfwd
星球	rfwh
伤心	rfxd
星空	rfxg
伤寒	rfxh
作家	rfxh
仿宋	rfxm
作案	rfxn
伤害	rfxs
作客	rfxw
作怪	rfxy
作对	rfyc
作证	rfyh
人生观	rfyk
亿	rga
创业	rgaa
伐	rgad
他	rgag
仍旧	rgar
似的	rgbd
电料	rgbm
仓皇	rgbw
电荷	rgcr
创举	rgdb
电学	rgdb
仓房	rgdo
电扇	rgdo
似	rgdr
电解	rgdu
创刊	rgea
电离	rgei
电阻	rgek
电动	rges
创造	rgfa
创制	rgfh
创	rggd
戗	rggg
电工	rggh
旷工	rggh
仓	rggn
电弧	rggp
仓库	rggv
电	rgh
电平	rghb
电炉	rghd
电灯	rghh
伺	rghk
旷	rghp
亿万	rghp
电焊	rghr
电表	rght
创建	rgie
电缆	rgja
电钻	rgja
电线	rgje
电镀	rgjg
电铃	rgjr
电路	rgka
电网	rgki
电器	rgkk
他国	rgkw
电站	rgla
创办	rglb
创立	rgld
电力	rglg
创新	rglh
俯冲	rglk
遢	rglz
电梯	rgmb
电枢	rgmh
伐木	rgmh
电机	rgmj
电极	rgmp
俯瞰	rgmw
价廉物美	rgnb
仝	rgnh
创始	rgns
电磁	rgob
电报	rgoe
电刷	rgoj
电视	rgok
保卫祖国	rgok
电码	rgom
电热	rgop
佛	rgpa
仍	rgpa
似乎	rgpb
曳	rgph
电气	rgqp
伺候	rgra
俯	rgrc
电影	rgre
创伤	rgrf
创作	rgrf
电量	rgrh
仓促	rgrk
电位	rgrl
他们	rgrm
他人	rgrp
旷野	rgrt
人工合成	rgrv
电信	rgry
电流	rgse
电波	rgsg
电池	rgsg
电汇	rgsh
电台	rgsk
电能	rgsu
电源	rgsv
垡	rgta
电场	rgtg
佛教	rgtp
电脑	rgue
电车	rgvh
电感	rgvh
电压	rgvt
电文	rgwd
电函	rgwg
仍然	rgxd
电容	rgxr
电讯	rgyg
电话	rgyp
电子	rgzw
命	rh
韪	rhaa
匙	rhab
题	rhab
便笺	rhae
伍	rhah
晤	rhak
代笔	rham
合算	rham
伙	rhan
是	rhar
是非	rhas
何等	rhat
俨	rhav
代管	rhax
佰	rhba
侠	rhbd
蛱	rhbd
代购	rhbd
债券	rhbe
合并	rhbk
代数	rhbm
倒数	rhbm
使节	rhcg
何苦	rhco
代劳	rhct
合营	rhct
剑	rhdd
何必	rhdg
佥	rhdh
伟大	rhdh
晴朗	rhdi
化整为零	rhdu
敛	rhdw
量变	rhea
便于	rheg
代替	rher
晴天	rher
命运	rhes
贷方	rhfd
仃	rhga
贷	rhgb
量度	rhgc
代	rhgd
佤	rhgd
俅	rhgd
晓	rhge
黛	rhgh
供不应求	rhgh
袋	rhgi
牮	rhgn
岱	rhgo
旦	rhh
伟	rhha
炅	rhhn
何不	rhhr
是否	rhhr
代表	rhht
便衣	rhid
倒退	rhig
伛	rhiw
合金	rhjp
代销	rhjx
命中	rhka
颌	rhkb
龠	rhkc
俪	rhkd
龛	rhkd
量刑	rhkd
使唤	rhkd
命	rhke
何	rhkg
代号	rhkh
合同	rhkh
代表团	rhkh
使	rhki
翕	rhkl
盒	rhkm
鸽	rhkn
合	rhkn
拿	rhko
歙	rhkq
俩	rhkr
合唱	rhkr
量具	rhks
代办	rhlb
合力	rhlg
何况	rhlk
愈加	rhlk
题目	rhma
倒闭	rhmh
题材	rhmh
合格	rhmw
债权	rhmy
何如	rhnk
例如	rhnk
侄女	rhnw
僵局	rhog
僵硬	rhoh
合拢	rhoo
伙食	rhop
贷款	rhos
债款	rhos
使馆	rhox
领事馆	rhox
合乎	rhpb
便利	rhpm
合适	rhpo
使得	rhpr
晓得	rhpr
傲气	rhqp
伙伴	rhrb
命令	rhrd
倒影	rhre
合影	rhre
合作	rhrf
合伙	rhrh
例题	rhrh
命题	rhrh
使命	rhrh
愈合	rhrh
便	rhri
显而易见	rhrk
倒伏	rhrq
僵化	rhrq
代价	rhrr
时至今日	rhrr
量	rhrt
偃	rhrw
倒	rhsd
人才济济	rhss
侄	rhst
合法	rhst
债	rhtb
僵	rhth
使者	rhtp
倒塌	rhtr
晴	rhtu
倩	rhtu
傲	rhtw
代用	rhua
合用	rhua
使用	rhua
合肥	rhub
傅	rhuc
俞	rhud
晡	rhud
命脉	rhud
倒霉	rhuf
觎	rhug
毹	rhum
愈	rhux
逾	rhuz
合成	rhvg
倒车	rhvh
何处	rhwa
倒班	rhwd
使劲	rhwd
便函	rhwg
债务	rhwl
伢	rhwp
僭	rhwr
代理	rhwr
合理	rhwr
例外	rhxa
例	rhxd
傲然	rhxd
便宜	rhxk
命名	rhxk
傲慢	rhxr
题词	rhyg
例证	rhyh
代谢	rhyo
合计	rhyo
伙计	rhyo
袋子	rhzw
鸽子	rhzw
盒子	rhzw
例子	rhzw
依	ri
侵占	riah
依	rian
伊	riap
依旧	riar
健美	ribw
伊朗	ridi
依附	rier
健	riez
依靠	rifa
健康	rigi
依赖	rihk
健壮	rila
依次	rilq
依存	rioa
侵袭	riog
依据	rioo
侵蚀	riov
依稀	ripm
侵入	ripn
侵犯	riqg
依照	rird
健全	rirw
侵略	ritw
侵	rity
依然	rixd
侵害	rixs
佩	rj
仉	rjag
电风扇	rjdo
舍己为人	rjdr
昕	rjha
佩	rjhj
舍己救人	rjhr
介绍信	rjry
佩服	rjue
仲	rkaa
禺	rkad
促	rkar
愚	rkax
保管	rkax
遇	rkaz
保养	rkbs
映	rkdh
保障	rkel
促进	rkep
俣	rker
保险	rker
遇险	rker
保育	rkes
保卫	rkga
侗	rkhk
遇到	rkhs
保镖	rkjx
侣	rkka
遇见	rkkp
保	rkma
煲	rkmh
堡	rkmt
保姆	rknm
保存	rkoa
保护	rkod
俜	rkog
保持	rkot
保有	rkou
侃	rkpg
保留	rkpg
保重	rkph
保暖	rkra
保修	rkra
映照	rkrd
愚昧	rkre
促使	rkrh
保健	rkri
保佑	rkro
全国人民代表	rkrr
保全	rkrw
俱	rksb
保温	rksr
愚蠢	rksr
堡垒	rkss
仲裁	rkti
促成	rkvg
愚弄	rkwc
保函	rkwg
全国各地	rkwt
保守	rkxc
保密	rkxd
保定	rkxh
保安	rkxn
保证	rkyh
位	rlah
电冰箱	rlam
仂	rlap
倍数	rlbm
体力劳动	rlce
暗藏	rlcv
位于	rleg
倍率	rlew
全力以赴	rlgz
昱	rlhh
暗杀	rlih
合资经营	rljc
倍	rlka
伽	rlka
暗中	rlka
暗示	rloh
暗自	rlpm
位移	rlpm
明辨是非	rlra
暗	rlrh
暗暗	rlrl
僮	rlrt
暗淡	rlsh
位置	rlso
位能	rlsu
代办处	rlwa
们	rmag
休	rman
体贴	rmba
果断	rmbm
颗粒	rmbm
休养	rmbs
冒进	rmep
冒险	rmer
冒充	rmes
体育	rmes
冒失	rmfd
体制	rmfh
果皮	rmgp
明目张胆	rmgu
体	rmha
颗	rmhb
冒火	rmhd
冒	rmhh
休整	rmhk
果	rmhn
杲	rmhn
体面	rmhp
晰	rmjh
体型	rmkd
果园	rmke
体形	rmkp
果肉	rmkr
体力	rmlg
勖	rmlh
果枝	rmmo
体检	rmmr
体验	rmmr
体格	rmmw
休眠	rmmw
果树	rmmy
鸺	rmna
果真	rmok
体操	rmok
体重	rmph
体系	rmpj
体积	rmpm
体委	rmpm
休息	rmpm
体质	rmpp
冒犯	rmqg
冒昧	rmre
体会	rmre
休会	rmre
休假	rmrw
果汁	rmso
体温	rmsr
果胶	rmue
体腔	rmux
体现	rmwk
果然	rmxd
果实	rmxd
夥	rmxx
体谅	rmye
果子	rmzw
件	rn
件	rnaa
侏	rnba
催	roaa
什	roaa
仙	roaa
优点	roah
早点	roah
早上	roah
估算	roam
伲	roba
优美	robw
偾	rocb
催芽	roch
值勤	roch
人尽其才	roch
早期	rocs
优良	rodi
僖	rodk
早熟	roek
做主	roet
优先	rofa
早先	rofa
早年	rofh
佐	roga
优	rogd
昵	rogh
做工	rogh
倔强	rogk
仕	roha
早	roha
佶	rohk
做事	rohk
优惠	rohr
从古到今	rohr
做到	rohs
僻静	roht
估	roka
佑	roka
僻	roko
值	roks
做	rokw
催产	rolp
电视机	romj
做梦	romm
仗	rona
佘	rond
仙女	ronw
倨	rook
早操	rook
电报挂号	rook
优势	roop
早饭	roop
做饭	roop
优秀	ropm
优质	ropp
优待	ropr
值得	ropr
什么	rops
早日	rora
值日	rora
早晚	rord
估量	rorh
催促	rork
做人	rorp
催化	rorq
优化	rorq
估价	rorr
早晨	rorv
优异	rosc
电视台	rosk
早春	rosr
做法	rost
畲	rotn
侑	roua
优胜	rouf
做成	rovg
值班	rowd
早已	rowh
倔	rowo
全神贯注	rows
优劣	roxp
做官	roxw
伎	roya
估计	royo
优越	rozh
低	rp
亻	rpa
低频	rpaa
介	rpan
昂首	rpbh
人道	rpbh
例行公事	rpbh
人类	rpbm
人世	rpch
低落	rpcs
侨	rpda
人大	rpdh
任免	rpdk
人为	rpdl
仰望	rpeg
人主	rpet
彷	rpf
人选	rpfa
人造	rpfa
低矮	rpfd
晌午	rpfo
人生	rpft
仇	rpga
低廉	rpgb
低	rpgd
昂	rpge
仰	rpge
昴	rpge
旯	rpgh
人工	rpgh
倜	rpgk
你	rpgx
您	rpgx
低下	rpha
仰卧	rpha
人才	rphg
曛	rphh
低速	rphk
人事	rphk
人烟	rphk
人群	rpik
介绍	rpjd
低级	rpjp
昂贵	rpka
人口	rpka
货币回笼	rpka
人员	rpkb
晌	rpkk
傻	rpkw
俄国	rpkw
佻	rpld
晁	rpld
人力	rplg
俱乐部	rplk
优质产品	rplk
人次	rplq
低音	rplr
介意	rplr
任意	rplr
俐	rpmd
人材	rpmh
倭	rpmn
人间	rpmr
人格	rpmw
人马	rpmw
低档	rpmx
人权	rpmy
人	rpn
人物	rpnd
你好	rpnz
您好	rpnz
仟	rpoa
赁	rpob
俄	rpod
昂扬	rpog
任	rpoh
低声	rpoh
人士	rpoh
凭	rpoj
仇视	rpok
人身	rpop
人手	rpop
信息社会	rpor
恁	rpox
众所周知	rppf
人称	rppm
人和	rppm
人种	rppm
仇敌	rppo
低垂	rppo
介质	rppp
人质	rppp
傻瓜	rppp
凭借	rprc
任何	rprh
任命	rprh
你们	rprm
人们	rprm
人体	rprm
低估	rpro
仇人	rprp
人人	rprp
任凭	rprp
仫	rpsa
人流	rpse
人海	rpsf
低温	rpsr
低沉	rpst
低洼	rpst
货币流通	rpsw
任用	rpua
侨胞	rpud
低压	rpvt
人民	rpwh
任务	rpwl
信息处理	rpww
昂然	rpxd
人心	rpxd
人性	rpxf
任性	rpxf
低空	rpxg
凭空	rpxg
人家	rpxh
人情	rpxh
仇恨	rpxi
人名	rpxk
低劣	rpxp
俄语	rpyh
凭证	rpyh
傻子	rpzw
化	rq
伏	rqad
华北	rqae
化	rqag
货船	rqaj
货舱	rqar
货	rqba
化学	rqdb
货色	rqdb
伏天	rqer
货运	rqes
化工	rqgh
华丽	rqhk
华东	rqhw
化纤	rqjp
华中	rqka
化装	rqla
化验	rqmr
货物	rqnd
伏特	rqnt
华	rqoa
华山	rqoa
化石	rqoh
华南	rqok
化身	rqop
货款	rqos
货币	rqpj
华侨	rqrp
华人	rqrp
电气化	rqrq
货源	rqsv
华沙	rqsx
化肥	rqub
货车	rqvh
但	rr
伸	rraa
从此	rrab
从简	rram
伦	rrba
从前	rrbh
晶粒	rrbm
偶数	rrbm
曝	rrcd
任人为贤	rrda
伶	rrdd
从头	rrdd
晗	rrdk
从	rrdn
偈	rrdw
从未	rrea
耸	rred
日日夜夜	rree
时时刻刻	rree
昆明市	rrej
伦敦	rrek
价值规律	rrep
侩	rres
电影院	rrex
伧	rrgg
伸张	rrgv
但	rrha
从严	rrha
从政	rrha
似是而非	rrha
从来	rrhb
丛	rrhd
偷	rrhd
念念不忘	rrhe
昌	rrhh
俭	rrhh
从事	rrhk
从而	rrhp
价钱	rrje
伸缩	rrjx
从中	rrka
偶	rrkd
偷听	rrkj
俎	rrks
耸立	rrld
从新	rrlh
偷盗	rrlq
倮	rrma
丛林	rrmm
坐标	rrmo
价格	rrmw
晶格	rrmw
伸展	rroc
伸直	rrok
从属	rrop
伸手	rrop
价	rrpa
偶尔	rrpg
晔	rrqo
倡	rrra
从今	rrrd
晶	rrrh
但是	rrrh
晶体	rrrm
众	rrrn
价值	rrro
伶俐	rrrp
众人	rrrp
偷偷	rrrr
倡导	rrsc
仅供参考	rrst
俚	rrta
坐	rrtd
电化教育	rrte
从军	rrtv
从略	rrtw
但愿	rrvb
昌盛	rrvg
伸长	rrvp
伸出	rrwa
怂恿	rrwd
丛书	rrwg
伦理	rrwr
怂	rrxd
偶然	rrxd
从小	rrxg
曝光	rrxh
偷懒	rrxh
从容	rrxr
众多	rrxx
倡议	rryd
曼	rs
贪污受贿	rsab
仨	rsah
曼谷	rsbr
俊	rsbw
领导干部	rsel
俟	rsfd
停滞不前	rshb
儇	rshi
低三下四	rshs
贪污盗窃	rslx
合法权益	rsmb
侔	rsna
氽	rsnd
俦	rspc
傣	rsrd
俸	rsro
曙	rstr
曙光	rsxh
曼	rsyh
里	rt
佃	rtah
野兽	rtbt
侍	rtca
野营	rtct
里头	rtdd
野蛮	rtea
野生	rtft
野火	rthd
里	rthh
偎	rthn
里面	rthp
侬	rtia
里边	rtlz
佬	rtpb
里程	rtpm
暑	rtpr
侍候	rtra
暝	rtrb
何去何从	rtrr
暑假	rtrw
里海	rtsf
佳	rtta
佃农	rtti
儡	rttt
晕	rtvh
晖	rtvh
野	rtwg
墅	rtwt
野外	rtxa
野心	rtxd
明	ru
佣	ruaa
明白	rubp
儒学	rudb
明朗	rudi
合肥市	ruej
明亮	ruek
明天	ruer
明知	rufd
明智	rufd
明年	rufh
儒	ruha
明	ruhh
明细	rujt
日用品	rukk
电脑部	rulk
盟	rumh
明媚	runw
明确	ruod
明日	rura
明显	rura
明星	rurf
明暗	rurl
明晰	rurm
佣人	rurp
使用价值	rurr
明月	ruup
明文	ruwd
明珠	ruwn
儒家	ruxh
晨	rv
伥	rvan
晨	rven
晟	rvgd
昃	rvrh
晨光	rvxh
从长计议	rvyy
全	rw
晷	rwak
全集	rwam
全盘	rwam
全勤	rwch
假若	rwco
假期	rwcs
佟	rwdd
暌	rwdd
俑	rwdo
人民大会堂	rwdx
全年	rwfh
侯	rwhd
人民政府	rwhg
旺	rwhh
全面	rwhp
假	rwhy
暇	rwhy
人民内部矛盾	rwkp
人民团体	rwkr
全县	rwks
全国	rwkw
曜	rwla
假装	rwla
全力	rwlg
全部	rwlk
全	rwnh
假如	rwnk
全局	rwog
全身	rwop
侪	rwpa
全民所有制	rwpf
人民币	rwpj
全程	rwpm
全息	rwpm
假日	rwra
全会	rwre
假使	rwrh
全体	rwrm
人民日报	rwro
人民代表大会	rwrr
全能	rwsu
全场	rwtg
全军	rwtv
旺盛	rwvg
全长	rwvp
全文	rwwd
全民	rwwh
全球	rwwh
假定	rwxh
全家	rwxh
全党	rwxt
假说	rwyb
假设	rwyj
假话	rwyp
佗	rxba
僳	rxbm
倘若	rxco
傺	rxdo
晒干	rxea
晃动	rxes
倥	rxga
伫	rxha
从容不迫	rxhb
晃	rxhe
晒	rxhh
暄	rxhh
偿还	rxhr
倘	rxkk
傈	rxma
晏	rxnh
傧	rxpb
偿命	rxrh
全党全国	rxrk
全心全意	rxrl
合情合理	rxrw
偿清	rxsh
傥	rxte
偿	rxts
俏	rxua
倌	rxwh
侈	rxxa
信	ry
佯	ryaa
傩	ryaa
信步	ryaa
信	ryah
信箱	ryam
仅	ryan
储蓄	ryce
储藏	rycv
信誉	rydb
信赖	ryhk
人言可畏	ryht
信号	rykh
电话号码	ryko
储存	ryoa
信息	rypm
信念	ryrd
储量	ryrh
信贷	ryrh
从难从严	ryrh
信件	ryrn
信任	ryrp
信仰	ryrp
仅仅	ryry
储	rytr
信封	rytt
信用	ryua
信服	ryue
储备	rywt
信心	ryxd
仔	rzah
电子工业部	rzgl
仔细	rzjt
三	s
四	sa
濒	saab
淮北	saae
滥	saam
涉	saap
耕	saba
耙	sabb
耨	sabc
耦	sabd
耪	sabf
耒	sabh
耜	sabk
耠	sabk
耥	sabk
耢	sabl
耗	sabm
耧	sabn
耱	sabo
耖	sabp
耩	sabt
耔	sabz
四散	sach
罪孽	sacp
罪过	sacz
艳	sadb
契	sadd
浮夸	sade
挈	sado
四角	sadu
恝	sadx
濒于	saeg
台北市	saej
滔天	saer
耘	saes
浮动	saes
四方	safd
丰收	saga
耗费	sagp
丰	sah
罪恶	saha
浈	sahb
滹	sahg
瀣	sahh
罡	sahh
沾	sahk
淖	saho
罩	saho
泸	saho
四面	sahp
滤	sahx
淑	sahy
契约	sajd
滤纸	sajp
滔	sajt
四围	sakh
罪状	sala
浮力	salg
丰产	salp
耗资	salq
滗	samt
砉	saoh
淮南	saok
耕牛	saow
四川	sapa
浮雕	sapg
契丹	sapg
四周	sapg
淫	saph
耕种	sapm
四季	sapm
淫秽	sapm
罪行	sapr
涉及	sapw
罪犯	saqg
四时	sarc
耕作	sarf
耦合	sarh
四化	sarq
丰满	sasc
溪流	sase
四海	sasf
涉水	sasg
滤清	sash
能上能下	sash
彗	sasi
沾染	sasp
罪	sass
慧	sasx
耕地	satg
淮	sath
滥用	saua
四肢	sauo
四月	saup
丰盛	savg
四处	sawa
溪	sawd
四通	sawd
浮现	sawk
四	sawp
涉外	saxa
丰富	saxh
罪名	saxk
河北省	saxp
湖北省	saxp
罪证	sayh
浮	sazt
耗子	sazw
测	sb
激战	sbah
海关总署	sbbs
激荡	sbcs
湓	sbdm
测	sbdt
汾	sbdt
泮	sbea
溅	sbed
激动	sbes
滋生	sbft
激	sbfw
测度	sbgc
涕	sbgp
湔	sbhd
溢	sbhm
滋	sbhs
激素	sbht
溯	sbhu
激烈	sbhx
滋补	sbia
滏	sbih
测绘	sbjr
测距	sbka
滋味	sbke
罾	sbkr
瀵	sbmb
测验	sbmr
激怒	sbny
没关系	sbpj
测量	sbrh
浴	sbrk
激昂	sbrp
激化	sbrq
激流	sbse
溢流	sbse
嗡	sbsl
滋润	sbsm
泊	sbth
激励	sbvh
滋长	sbvp
溢出	sbwa
漾	sbwn
激发	sbwp
湟	sbwt
皴	sbwy
逡	sbwz
测定	sbxh
激光	sbxh
激情	sbxh
浴室	sbxh
测试	sbyh
激起	sbzj
满	sc
异步	scaa
导航	scae
滞	scaj
导师	scap
导管	scax
弁	scda
洪亮	scek
满天	scer
泔	scet
满族	scff
异	scga
导弹	scgb
导	scgd
洪	schb
潢	schb
灌区	schi
渫	schm
满面	schp
满	schr
港	schs
导致	schs
泄	schw
懑	schx
潇	scib
导线	scje
滞销	scjx
灌	scka
港口	scka
满足	scka
异同	sckh
满意	sclr
灌木	scmh
异样	scmy
异物	scnd
导热	scop
导向	scpk
漭	scqc
泄气	scqp
漠	scrd
导电	scrg
导体	scrm
淇	scsb
满洲	scsd
港湾	scse
洪流	scse
导游	scsf
灌水	scsg
洪水	scsg
灌溉	scsi
澌	scsj
泄漏	scso
港澳	scsp
湛	scsw
导演	scsx
潇洒	scsx
滢	sctd
潆	sctj
涝	sctl
满载	sctv
泄露	scuk
满腔	scux
灌输	scvr
满心	scxd
泄密	scxd
异性	scxf
满怀	scxh
江苏省	scxp
异常	scxt
异议	scyd
参	sd
参战	sdah
梁	sdbm
粱	sdbm
参数	sdbm
潦	sdbx
涣散	sdch
浪花	sdcr
涩	sdda
浪头	sddd
汰	sddt
氵	sddt
淘	sdft
泌	sdgd
泳	sdgn
浪费	sdgp
置之度外	sdgx
参政	sdha
参与	sdhg
浪	sdin
涣	sdkd
浼	sdkg
参见	sdkp
沼	sdkt
沩	sdld
参加	sdlk
参阅	sdmb
沪	sdot
洲	sdpa
参看	sdpe
毵	sdpm
参	sdpp
淘气	sdqp
参照	sdrd
淹	sdrg
罨	sdrg
洵	sdrt
叁	sdsd
淘汰	sdsd
三角洲	sdsd
泡沫	sdsh
淹没	sdsj
浪潮	sdso
浪漫	sdsr
浪涛	sdss
沟	sdst
泡	sdst
沼泽	sdsy
畚	sdtd
参考	sdtp
参军	sdtv
蜀	sdvh
澹	sdvy
沟通	sdwd
参谋	sdyc
参议	sdyd
参观	sdyk
流	se
汴	sead
湾	seag
滚筒	seak
滦	seam
潜艇	seap
汗	seat
滂	sebf
滚	sebi
滴	sebk
浅薄	secs
污蔑	secs
浅色	sedb
液态	sedd
允	sedg
注解	sedu
沈阳市	seej
滚动	sees
流动	sees
沅	seet
流氓	seew
流亡	seew
流失	sefd
浅	segd
污	segt
淬火	sehd
流速	sehk
清规戒律	sehp
流毒	seht
汗衫	seip
漓	seis
沆	sejt
澶	sekh
濠	sekn
淳	sekz
潜力	selg
添加	selk
流动资产	sell
流产	selp
注意	selr
泐	selt
淳朴	sema
注目	sema
潜在	seoa
注射	seoc
注视	seok
注释	sepb
注册	sepg
注重	seph
流程	sepm
流利	sepm
流血	sepm
污秽	sepm
注入	sepn
流行	sepr
流畅	sera
浅显	sera
添	serd
流传	sere
流星	serf
流量	serh
流体	serm
液体	serm
液	sern
淬	sero
潜伏	serq
液化	serq
潜	serr
液晶	serr
滁	serx
流浪	sesd
滚滚	sese
流	sesg
汗水	sesg
流水	sesg
潜水	sesg
污水	sesg
鎏	sesj
添置	seso
污泥	seso
流派	sesp
污染	sesp
污浊	sesv
澈	sesw
流沙	sesx
洱	seth
流域	seth
污垢	setp
注	sett
流露	seuk
海市蜃楼	sevm
淳厚	sevr
液压	sevt
瀛	sewd
流通	sewd
滚珠	sewn
汗珠	sewn
泫	sews
滴定	sexh
注定	sexh
流言	seyd
允许	seyf
滠	seyy
滚子	sezw
游览	sfaa
洗	sfae
海上	sfah
游船	sfaj
浩	sfak
海关	sfbe
浩荡	sfcs
矣	sfdd
浩大	sfdh
海防	sfef
游离	sfei
游击	sfeo
海运	sfes
游动	sfes
漩	sffr
游	sffz
沲	sfgg
海底	sfgp
汔	sfgt
海鸥	sfhi
海区	sfhi
海面	sfhp
海牙	sfhw
洗衣	sfid
海员	sfkb
海盗	sflq
海	sfmt
游牧	sfnw
海峡	sfoh
海蜇	sfoj
海拔	sfoo
海岸	sfov
淤积	sfpm
游行	sfpr
淤	sfrd
游人	sfrp
海里	sfrt
海港	sfsc
海参	sfsd
游泳	sfsd
海湾	sfse
海水	sfsg
洗澡	sfsk
浩瀚	sfso
淤泥	sfso
洗涤	sfsw
海滨	sfsx
海滩	sfsy
海洋	sfsy
海域	sfth
浩劫	sfts
海军	sftv
海轮	sfvr
海外	sfxa
海棠	sfxt
游戏	sfyg
水	sg
池	sgag
沸点	sgah
渡船	sgaj
水箱	sgam
水管	sgax
濂	sgbb
水分	sgbd
波兰	sgbs
江苏	sgcl
水草	sgcr
波斯	sgcs
渡	sgcy
渡过	sgcz
水解	sgdu
水陆	sgee
水井	sgep
波动	sges
能工巧匠	sggh
水底	sggp
水库	sggv
水平	sghb
溏	sgik
水银	sgji
波纹	sgjw
渡口	sgka
消费品	sgkk
波形	sgkp
水准	sgla
水力	sglg
溺	sgll
水产	sglp
水冷	sglr
羁	sgmh
水桶	sgmw
鸿	sgnt
江山	sgoa
波折	sgoj
江南	sgok
水手	sgop
水泵	sgos
汛	sgot
江岸	sgov
水牛	sgow
沸	sgpa
波段	sgpa
烫	sgph
水系	sgpj
水稻	sgpm
水利	sgpm
婆	sgpn
汤	sgpp
水质	sgpp
波及	sgpw
波	sgpy
水电	sgrg
水位	sgrl
水果	sgrm
水体	sgrm
水仙	sgro
水化	sgrq
水晶	sgrr
涨价	sgrr
波浪	sgsd
水滴	sgse
水流	sgse
水洗	sgsf
沸水	sgsg
婆婆	sgsg
水池	sgsg
波澜	sgsm
江湖	sgso
水泥	sgso
水汽	sgsq
波涛	sgss
泓	sgst
水能	sgsu
水源	sgsv
水田	sgta
池塘	sgtg
水塘	sgtg
江	sgth
水土	sgth
水域	sgth
沸腾	sgub
水肿	sguk
水车	sgvh
波长	sgvp
涨	sgvt
漉	sgwb
水文	sgwd
水球	sgwh
水	sgwp
水性	sgxf
江西	sgxh
水灾	sgxh
池子	sgzw
清	sh
河北	shae
沔	shag
浇筑	shag
浯	shak
汇集	sham
清算	sham
浃	shbd
河道	shbh
渠道	shbh
汇总	shbk
涞	shbm
清白	shbp
河谷	shbr
清单	shbr
三节	shcg
漕	shcr
淡薄	shcs
河蟹	shdu
三角	shdu
清除	sher
汇率	shew
浇	shge
河床	shgm
汀	shgt
三	shhh
淡	shht
清静	shht
河东	shhw
沤	shiw
汇编	shjd
浇铸	shjs
沛	shjt
河口	shka
涑	shkb
濑	shkb
河	shkg
漱	shkq
河内	shkr
三国	shkw
清凉	shle
清新	shlh
清楚	shmm
清闲	shmm
三相	shmm
清查	shmr
沫	shmt
三棱	shmt
河山	shoa
汇报	shoe
三峡	shoh
没事找事	shoh
清扫	shoi
河南	shok
满不在乎	shop
汇款	shos
河岸	shov
河川	shpa
三九	shpg
湎	shph
清香	shpm
清秀	shpm
涿	shpn
三七	shqh
罘	shrd
洹	shrh
汇合	shrh
清晰	shrm
清早	shro
淡化	shrq
清华	shrq
清明	shru
清晨	shrv
清偿	shrx
浇灌	shsc
河流	shse
清澈	shse
清洗	shsf
淡水	shsg
浇水	shsg
清水	shsg
清汤	shsg
淡淡	shsh
河沿	shsj
满面春风	shsj
清洁	shso
渍	shtb
清	shtu
三军	shtv
浦	shud
清脆	shud
三月	shup
沌	shwg
渠	shwm
清理	shwr
汇	shwt
洌	shxd
淡然	shxd
河西	shxh
汇票	shxo
清醒	shyr
浸	si
津贴	siba
浔	sict
津	siea
溉	sigg
洗衣机	simj
浠	sioj
淆	siou
浸入	sipn
浸泡	sisd
浸渍	sish
浸润	sism
汹涌	sisw
浸	sity
汹	siwa
沿	sj
潍	sjat
溲	sjay
没落	sjcs
没收	sjga
沿线	sjje
沿	sjkt
没有	sjou
沿岸	sjov
汇编程序	sjpg
沿途	sjre
沿海	sjsf
沂	sjta
淦	sjth
没用	sjua
沿用	sjua
沿着	sjym
没	sjyt
汇编语言	sjyy
油	sk
溃	skab
台北	skae
台上	skah
潞	skak
油箱	skam
浞	skar
油管	skax
油料	skbm
油菜	skca
澧	skcd
溃散	skch
油茶	skcr
台	skdh
洇	skdh
泱	skdt
邰	sked
吮	skeh
油井	skep
台阶	sker
滑动	skes
怠工	skgh
溃疡	skgl
炱	skhd
涠	skhh
溷	skhh
台灯	skhh
油灯	skhh
洞	skhk
油画	skht
溃退	skig
台风	skji
洞口	skka
澡	skkm
涡	skkr
漶	skkx
滑冰	skls
油毡	skma
油松	skmb
涸	skoh
油	skoh
油布	skoj
油泵	skos
油印	skpg
滑稽	skpm
滑行	skpr
油气	skqp
渑	skrg
泅	skrh
台湾	skse
油污	skse
涡河	sksh
油漆	sksm
沮	skst
油田	skta
油脂	skub
滑雪	skui
涓	skut
滑车	skvh
滑轮	skvr
涡轮	skvr
油压	skvt
台球	skwh
滑	skwu
怠	skxd
洞穴	skxd
怠慢	skxr
洞察	skxx
台词	skyg
迨	skzd
台子	skzw
泣	sl
潼关	slbe
涪	slkt
漳	slro
潼	slrt
泣	slth
泪	sm
濉	smat
三极管	smax
淞	smbs
泪花	smcr
渺茫	smcs
沭	smdt
汗马功劳	smgc
泪痕	smgl
澜	smhb
淅	smjt
漆黑	smkb
漤	smmn
淋	smmt
湘	smmt
潸	smmu
海枯石烂	smoh
渺视	smok
漆	smrd
渣	smrh
涧	smrt
淋浴	smsb
沐浴	smsb
泪水	smsg
润滑	smsk
润湿	smsr
泪	smth
洫	smth
沐	smtn
泪珠	smwn
润	smwt
渺小	smxg
渺	smxp
洙	snbt
牟	snda
洳	snkt
汝	snth
置	so
湖北	soae
洁白	sobp
泥	sobt
澍	sodc
漏斗	sodd
澎	sodp
济南市	soej
温故知新	sofl
泷	sogd
渎	sogd
湍	soha
洁	sohk
渥	soht
涮	sojd
浙	sojt
滇	sokb
罟	sokh
罱	soko
置	soks
沽	sokt
湖	soku
泥浆	sola
洁净	sold
置换	sood
湖南	sook
置身	soop
海南岛	sopg
潮气	soqp
漏气	soqp
瀚	sorl
潮	soru
涔	sorw
置信	sory
湖泊	sosb
潮流	sose
湍流	sose
汁液	sose
渤海	sosf
潮水	sosg
浙江	sosg
漏洞	sosk
潮湿	sosr
湖滨	sosx
泥泞	sosx
泥沙	sosx
汕	sota
汁	sota
泥土	soth
渤	sotl
漏	sout
洧	sout
河南省	soxp
湖南省	soxp
潺	sozz
派	sp
浜	spab
涎	spaz
渊	spba
染料	spbm
潘	spbt
寿	spch
焘	spch
染色	spdb
派头	spdd
鋈	spdj
泛	spdn
沃	spdt
邦交	speb
邦	speh
帮	spej
湃	speo
活动	spes
派生	spft
泖	spge
染	spgm
溜	spgt
滚瓜烂熟	sphe
三番五次	sphl
帮凶	spiw
帅	spj
活跃	spka
派遣	spka
澳	spkd
派别	spkl
帮助	spks
洮	spld
活力	splg
濞	spma
澳门	spmd
溴	spmq
洎	spmt
潲	spmu
渊博	spoh
活	spok
帮手	spop
派系	sppj
派	sppn
寿命	sprh
活化	sprq
泛滥	spsa
帮派	spsp
活活	spsp
渊源	spsv
活泼	spsw
深入浅出	spsw
寿辰	spve
法律顾问	spvm
汲	spwn
泺	spwx
帮忙	spxe
活性	spxf
派性	spxf
活塞	spxh
四川省	spxp
活该	spye
汽	sq
汽船	sqaj
汽笛	sqak
漪	sqdg
沏	sqdt
汽缸	sqfg
汽锅	sqjk
柒	sqmt
汽化	sqrq
汽水	sqsg
汽油	sqsk
汽	sqtg
潴	sqtr
汽车	sqvh
温	sr
漫步	sraa
濮	srad
湿	srah
混战	srah
混	srbb
涂料	srbm
混养	srbs
沦	srbt
温带	srca
瀑	srcd
春节	srcg
春花	srcr
春色	srdb
泠	srdd
沦为	srdl
奉	srea
灏	sreb
春联	sreb
沦陷	sred
春天	srer
漫天	srer
浍	sres
涂	srex
溆	srey
奉告	srfa
混蛋	srga
湿度	srgc
温度	srgc
泰	srgd
沧	srgg
溻	srgl
温习	srgl
瀹	srhc
渝	srhd
洽	srhk
三令五申	srhr
漫画	srht
潋	srhw
四化建设	sriy
混纺	srjf
舂	srjh
春风	srji
涂改	srjw
混同	srkh
泰国	srkw
水电站	srla
温	srmt
沓	srnh
泰山	sroa
温存	sroa
瀑布	sroj
奉献	srok
春播	srop
奏	srpd
混杂	srpg
秦	srpm
春季	srpm
春秋	srpm
温和	srpm
混入	srpn
混乱	srpo
奉行	srpr
没什么	srps
奏乐	srpw
湿气	srqp
温暖	srra
春	srrh
奉命	srrh
混合	srrh
春晖	srrt
蠢	srrv
春耕	srsa
沧海	srsf
春游	srsf
温水	srsg
混淆	srsi
湿润	srsm
混浊	srsv
漫	srsy
汨	srth
汩	srth
春雨	sruh
春雷	srut
漫长	srvp
温柔	srwd
四个现代化	srwr
春光	srxh
温情	srxh
温室	srxh
温差	sryg
漫谈	sryh
洽谈	sryh
沧桑	sryy
奉承	srze
治	ss
滟	ssab
沣	ssat
巽	sscb
渗	ssdp
治病	ssgl
治疗	ssgl
滔滔不绝	sshj
治	sskt
港澳同胞	ssku
治国	sskw
清清楚楚	ssmm
涛	sspc
渗透	sspm
渗入	sspn
溱	ssrm
汗流浃背	sssa
治水	sssg
淼	sssn
渗漏	ssso
垒	ssst
汜	sstg
泗	ssth
渗出	sswa
治理	sswr
治安	ssxn
台湾省	ssxp
浙江省	ssxp
法	st
深受	stat
法则	stbd
深	stbm
沉迷	stbm
法学	stdb
深色	stdb
法郎	stdi
罢免	stdk
沉陷	sted
深远	stee
罢市	stej
法规	ster
深夜	ster
沈阳	ster
沉降	stew
深刻	stew
法院	stex
法制	stfh
浓度	stgc
深度	stgc
罢工	stgh
沉痛	stgl
法庭	stgp
淠	stha
满载而归	stha
泻	sthh
沉静	stht
浓	stit
沉	stjt
漯	stjt
满城风雨	stju
浓缩	stjx
沉默	stkb
法典	stkc
沉吟	stkr
法国	stkw
参考资料	stlb
沉闷	stmx
法权	stmy
深山	stoa
浑身	stop
深翻	stpb
沈	stpg
沉重	stph
浓重	stph
深重	stph
法币	stpj
深奥	stpk
沉积	stpm
沉稳	stpm
深秋	stpm
深入	stpn
署	stpr
渚	stpr
法律	stpr
深切	stqd
溟	strb
法令	strd
罢休	strm
法人	strp
深化	strq
深信	stry
沉浮	stsa
深耕	stsa
深浅	stse
沉溺	stsg
深水	stsg
罢	stsh
罴	stsh
浓淡	stsh
沉浸	stsi
沉没	stsj
溘	stsm
深渊	stsp
参考消息	stsp
沉沦	stsr
法治	stss
法	stst
深沉	stst
深深	stst
浑浊	stsv
沉淀	stsx
深圳	sttp
洼	sttt
沉思	sttx
深思	sttx
渭	stut
浑厚	stvr
浓厚	stvr
深厚	stvr
浑	stvt
深处	stwa
罢了	stwg
参考书	stwg
深邃	stxb
浓密	stxd
法定	stxh
法家	stxh
深情	stxh
署名	stxk
法案	stxn
法官	stxw
沉醉	stye
沉着	stym
罢课	styr
能	su
渔业	suaa
渔船	suaj
能	subb
熊	subh
淝	subt
能够	sudk
能为	sudl
能干	suea
能动	sues
能知	sufd
灞	sugu
濡	suha
能耐	suhp
能否	suhr
能级	sujp
渔具	suks
能力	sulg
能手	suop
熊猫	suqc
能量	surh
熊熊	susu
能源	susv
渔场	sutg
渔	suth
渔民	suwh
源	sv
源泉	svbs
源	svbx
渐变	svea
溽	svec
沥青	svht
渐	svjt
渐次	svlq
沥	svlt
渐渐	svsv
源源	svsv
浊	svtd
逻辑思维	svtj
涯	svtt
逻辑设计	svyy
涟	svzt
凼	swad
四通集团	swak
湄	swam
四通公司	swbg
涵养	swbs
厶	swd
澄	swdd
泾	swdg
涵义	swdi
涌	swdo
浏	swdt
渌	swen
洛阳	swer
澉	swew
涵	swga
洚	swha
巳	swhg
泯	swhg
涤	swhx
涤纶	swjr
洛	swkt
淄博	swoh
济南	swok
济	swpa
泼	swpy
能文能武	swse
澄清	swsh
浚	swt
汪	swth
汶	swtn
濯	swwa
涌现	swwk
淄	swwt
溶	sx
滨临	sxaa
罹	sxah
演算	sxam
淀粉	sxbm
漂白	sxbp
沱	sxbt
沙皇	sxbw
消散	sxch
演义	sxdi
溶解	sxdu
演变	sxea
浣	sxee
消防	sxef
漂亮	sxek
消除	sxer
消亡	sxew
消失	sxfd
消瘦	sxgl
演习	sxgl
消磨	sxgm
消费	sxgp
演	sxhb
罗	sxhd
泞	sxhg
渲	sxhh
消灭	sxhh
淀	sxhr
消毒	sxht
沙锅	sxjk
汉字编码	sxjo
演员	sxkb
沙哑	sxkh
淌	sxkk
演唱	sxkr
滓	sxlo
消极	sxmp
溧	sxmt
罗马	sxmw
演示	sxoh
消逝	sxoj
漂	sxot
淙	sxot
沙丘	sxpa
滨	sxpb
裟	sxpi
漂移	sxpm
消息	sxpm
娑	sxpn
挲	sxpo
溶质	sxpp
沙	sxpt
鲨	sxpu
渖	sxra
溶	sxrk
潭	sxro
沙俄	sxrp
溶化	sxrq
消化	sxrq
演化	sxrq
海外侨胞	sxru
漂浮	sxsa
消耗	sxsa
漂泊	sxsb
沙漠	sxsc
溶液	sxse
滨海	sxsf
渲染	sxsp
演奏	sxsr
消沉	sxst
沙滩	sxsy
沁	sxtd
汐	sxtd
洒	sxth
沙土	sxth
湮	sxtt
消	sxut
逻辑	sxvk
演出	sxwa
涫	sxwh
溶剂	sxwp
沙发	sxwp
丰富多采	sxxa
江西省	sxxp
演说	sxyb
演讲	sxye
逻	sxzh
沙子	sxzw
汉	sy
汉卡	syah
滩	syat
酒精	sybm
洋葱	sycd
罚	sydh
汊	sydt
泽	syea
深谋远虑	syea
汉阳	syer
汉族	syff
浒	syfo
酒店	syga
参差不齐	syhw
洋钱	syje
罚金	syjp
汉口	syka
酒楼	symb
罚款	syos
测试版	sypa
能说会道	syrb
酒会	syre
酒量	syrh
汉人	syrp
洋人	syrp
洋溢	sysb
洋洋	sysy
洋	syta
酒	syth
汉	sytn
参谋长	syvp
汉字	syxz
汉语	syyh
汉子	syzw
他	t
田	ta
截止	taaa
截断	tabm
埒	tact
盐	tadm
田亩	taet
截取	taey
堆放	tafw
截	tagd
墟	tahh
坫	tahk
垆	taho
截面	tahp
堆焊	tahr
田鼠	tajg
田间	tamr
鹤	tang
堆积	tapm
田径	tapr
田里	tart
田野	tart
盐水	tasg
田地	tatg
堆	tath
址	tath
田埂	tath
田	tawh
截然	taxd
盐酸	tays
增	tb
毗	tbbh
增益	tbbh
增大	tbdh
罕	tbea
畔	tbea
幸	tbea
幸亏	tbeg
增高	tbek
增进	tbep
幸运	tbes
增收	tbga
增强	tbgk
增殖	tbhx
罕见	tbkp
增	tbkr
增加	tblk
增产	tblp
增减	tblv
幸好	tbnz
增援	tboa
幸福	tboh
埤	tbpo
增量	tbrh
增值	tbro
增添	tbse
坝	tbtd
逵	tbtz
增长	tbvp
增多	tbxx
增设	tbyj
塔	tc
坩	tcet
寺院	tcex
寺	tchd
堞	tchm
塔	tcrk
堪	tcsw
坩埚	tctk
均	td
埋头苦干	tdce
均匀	tddl
垮	tdeg
冖	tdg
埋头工作	tdgr
畸	tdhg
冤	tdkd
堍	tdkd
畸形	tdkp
均	tdlt
冤枉	tdmw
冤屈	tdow
均衡	tdpr
埯	tdrg
垮台	tdsk
冤家	tdxh
冤案	tdxn
坑	te
墒	tebk
冠	teec
教育方针	tefj
圩	tegt
圬	tegt
垴	teia
壤	teki
壕	tekn
墩	tekw
教育部	telk
壕沟	tesd
坛	test
冠军	tetv
垓	tewr
坊	tf
圪	tfgt
坊	tftg
地	tg
地步	tgaa
地	tgag
地点	tgah
地盘	tgam
地道	tgbh
地带	tgca
地基	tgcs
地学	tgdb
地方	tgfd
坡度	tggc
地皮	tggp
地下	tgha
地平	tghb
地区	tghi
场面	tghp
地面	tghp
地表	tght
塘	tgik
墉	tgio
地铁	tgjf
地形	tgkp
地图	tgkw
地产	tglp
场次	tglq
地毯	tgmh
地板	tgmp
地层	tgoe
地壳	tgoh
地热	tgop
地势	tgop
地支	tgoy
地段	tgpa
地利	tgpm
地委	tgpm
地租	tgpm
场	tgpp
场所	tgpp
地质	tgpp
坡	tgpy
地狱	tgqy
场景	tgre
场合	tgrh
地位	tgrl
地价	tgrr
地温	tgsr
地址	tgta
场地	tgtg
地域	tgth
圹	tgtp
地雷	tgut
地震	tguv
地球	tgwh
地理	tgwr
地名	tgxk
场子	tgzw
写	th
土	thah
垭	thah
坯料	thbm
坪	thbo
土方	thfd
写生	thft
坏蛋	thga
写	thgh
町	thgh
畏	thgn
坏死	thhx
畏缩	thjx
塥	thka
域	thkd
坷	thkg
农副产品	thlk
土产	thlp
畀	thpa
冢	thpn
写入	thpn
军事委员会	thpr
坏	thrd
写作	thrf
坯	thrh
垣	thrh
埂	thri
坏人	thrp
堰	thrw
垤	thst
写法	thst
土壤	thte
土地	thtg
埔	thud
坏处	thwa
畏惧	thxk
畏难	thya
农	ti
农业	tiaa
裁判	tibe
裁剪	tibh
坑道	tibh
农药	ticj
农学	tidb
农户	tido
封建主义	tied
裁	tigd
农	tign
垠	tign
埭	tign
农副	tihk
坑	tijt
裁缝	tijw
裁员	tikb
农具	tiks
裁减	tilv
裁决	tilw
农村	timc
农机	timj
农林	timm
农奴	tiny
农贸	tipg
农活	tisp
农田	tita
农场	titg
埽	titj
裁军	titv
农历	tivl
农民	tiwh
农忙	tixe
裁定	tixh
农家	tixh
累	tj
坼	tjdt
冗	tjgg
累	tjhd
垛	tjmt
累积	tjpm
圻	tjta
圮	tjtg
累计	tjyo
袁	tk
埙	tkbt
哉	tkgd
垌	tkhk
老中青	tkht
袁	tkih
埚	tkkr
埕	tkwt
境	tl
培养	tlbs
培育	tles
男生	tlft
男	tlhp
境内	tlkr
培	tlkt
境况	tllk
培植	tlmo
嬲	tlnl
男女	tlnw
境	tlre
境遇	tlrk
男人	tlrp
疃	tlrt
境地	tltg
垃	tlth
培土	tlth
垃圾	tltp
境界	tltr
男性	tlxf
培训	tlyp
男孩	tlze
男子	tlzw
栽	tm
思想方法	tmfs
栽	tmgd
栽植	tmmo
栽种	tmpm
坶	tmtd
栽培	tmtl
墙	to
墀	toan
墙	tobh
填料	tobm
坭	tobt
墙角	todu
填充	toes
垅	togd
填补	toia
垲	tojt
填	tokb
埴	toks
填报	tooe
墙壁	took
煮	torh
煮沸	tosg
填写	toth
堀	towo
教研室	toxh
都	tp
圳	tpaa
考虑	tpah
老虎	tpah
教师	tpap
老师	tpap
埏	tpaz
老	tpbh
赤道	tpbh
赫兹	tpbh
老爹	tpbi
老爷	tpbi
老总	tpbk
耄	tpbm
耆	tpbr
教养	tpbs
耋	tpbt
考勤	tpch
老营	tpct
教学	tpdb
老头	tpdd
都市	tpej
教育	tpes
农贸市场	tpet
老年	tpfh
赤	tpgb
赫	tpgb
坻	tpgd
郝	tpge
坍	tpge
坞	tpgh
鸩	tpgn
赭	tpgr
螫	tpgv
赦	tpgw
赧	tpgy
考	tphg
老鼠	tpjg
教练	tpjh
教员	tpkb
老兄	tpke
垧	tpkk
考核	tpme
教材	tpmh
老板	tpmp
考查	tpmr
考验	tpmr
教授	tpoa
老挝	tpoc
教研	tpok
考古	tpok
老手	tpop
垢	tppk
教程	tppm
坂	tppy
畈	tppy
老伴	tprb
都	tpre
教会	tpre
者	tprh
翥	tprl
老人	tprp
老化	tprq
教导	tpsc
老婆	tpsg
老汉	tpsy
老农	tpti
都城	tptv
赤脚	tput
老成	tpvg
赤眉	tpwa
教书	tpwg
教条	tpwh
圾	tpwn
埠	tpwo
老乡	tpww
老实	tpxd
教室	tpxh
老家	tpxh
老少	tpxp
教堂	tpxt
考察	tpxx
赤字	tpxz
教诲	tpyf
考试	tpyh
考证	tpyh
教训	tpyp
赤诚	tpyv
孝	tpzh
教	tpzw
老子	tpzw
坎	tq
畎	tqhd
坎	tqtn
界	tr
坤	trat
坦白	trbp
埋葬	trch
埘	trct
埋藏	trcv
埋头	trdd
幂	trdj
埸	trdp
埝	trdx
冥	treb
堤防	tref
界限	trei
坦率	trew
塌	trgl
界面	trhp
堤	trhr
坦	trht
界线	trje
农作物	trnd
坦克	trok
堤岸	trov
界	trpa
畛	trpp
埋伏	trrq
埋没	trsj
墁	trsy
堤坝	trtb
埋	trtt
堠	trwd
冠冕堂皇	trxb
坦然	trxd
埋怨	trxg
却	ts
却步	tsaa
畴	tsch
去世	tsch
墚	tsdm
却	tseh
埃	tsfd
去年	tsfh
塄	tsft
去	tshd
去路	tska
劫	tslh
盍	tsmh
去掉	tsoa
去向	tspk
埃及	tspw
圯	tstg
封	tt
卦	ttad
戴	ttcd
封	ttch
圭	tthh
封面	tthp
封建	ttie
土地改革	ttjg
封锁	ttjx
封闭	ttmh
封存	ttoa
堵	ttpr
堵住	ttre
农田水利	ttsp
畦	ttth
恚	ttxh
堵塞	ttxh
胃	tu
胃	tuhh
胃口	tuka
胃液	tuse
堋	tuut
军	tv
军舰	tvak
塬	tvbx
军警	tvcd
载荷	tvcr
军营	tvct
城郊	tveb
郓	tveg
城市	tvej
军队	tver
载运	tves
军	tvga
城	tvgd
载	tvgd
军费	tvgp
皲	tvgy
军政	tvha
军火	tvhd
军医	tvhf
城区	tvhi
军区	tvhi
军事	tvhk
城镇	tvjo
军装	tvla
军部	tvlk
坜	tvlt
城门	tvmd
军机	tvmj
军阀	tvmr
军士	tvoh
军属	tvop
载重	tvph
军委	tvpm
军人	tvrp
城里	tvrt
载波	tvsg
城墙	tvto
军用	tvua
军服	tvue
军需	tvuh
军长	tvvp
军民	tvwh
军务	tvwl
军备	tvwt
城乡	tvww
军官	tvxw
块	tw
略带	twca
坟墓	twcr
块	twdt
块儿	twep
畋	twhn
略	twkh
块状	twla
略微	twpr
农民日报	twro
坳	twsl
坟	twtn
略去	twts
思	tx
思虑	txah
坨	txbt
垸	txee
思	txhd
截然不同	txhk
思维	txja
思绪	txjt
思路	txka
思想	txmm
思索	txot
思念	txrd
思潮	txso
思考	txtp
堙	txtt
畹	txxg
培训中心	tykx
与	u
用	ua
鲣	uaat
霍	uadh
用户	uado
用武	uaea
用于	uaeg
鳐	uaft
用以	uagd
用功	uagl
用	uah
用来	uahb
胩	uahd
鲇	uahk
胪	uaho
鲈	uaho
用品	uakk
用具	uaks
用力	ualg
用意	ualr
用尽	uaon
用途	uare
用人	uarp
腓	uass
霏	uass
鲱	uass
用法	uast
用处	uawa
用心	uaxd
用光	uaxh
用语	uayh
脬	uazh
脱	ub
肥料	ubbm
脱粒	ubbm
肥皂	ubbq
脱节	ubcg
脱落	ubcs
肥大	ubdh
肥胖	ubeb
肥效	ubeb
滕	ubed
脱离	ubei
腾	ubem
媵	uben
朕	uber
塍	ubet
肥	ubhg
脱销	ubjx
脱	ubke
胼	ubkh
脱产	ublp
鳞	ubma
膦	ubma
脒	ubmh
脱身	ubop
鳞片	ubpa
脾	ubpo
脾气	ubqp
脱氧	ubqy
脂	ubrh
脱水	ubsg
腺	ubsh
肥沃	ubsp
脂肪	ubuf
鳇	ubwt
腾空	ubxg
鳟	ubyc
膜	uc
肘	uchd
鲽	uchm
腊	uchr
霰	uchw
膜	ucrd
朦	uctn
朦胧	ucuo
腊月	ucup
胸	ud
肽	uddh
胯	udeg
脉	udgn
刖	udhg
胸	udia
胸襟	udim
朐	udkh
胸围	udkh
脉冲	udlk
胸部	udlk
鳊	udoc
脉搏	udoh
脉石	udoh
腌	udrg
雹	udsd
胞	udsh
鲍	udst
胸脯	uduh
胸腔	udux
胸膛	udux
脆	udvg
脆性	udxf
胸怀	udxh
脑	ue
肝	ueah
脑筋	ueau
胶卷	uebe
膀	uebf
鲛	uebi
胶	uebi
膪	uebk
肤色	uedb
朊	ueeh
雩	uegd
肟	uegh
胶皮	uegp
肝炎	uehh
脑	ueia
肮	uejh
膻	uekh
鲸	uekx
服装	uela
脑力	uelg
腾云驾雾	uelu
脑壳	ueoh
胶布	ueoj
肼	uepa
胶片	uepa
服役	uepr
服气	ueqp
肤	uerh
脑袋	uerh
胶合	uerh
胶体	uerm
腋	uern
服从	uerr
服侍	uert
肤浅	uese
脑海	uesf
胶泥	ueso
服用	ueua
肮脏	ueug
肝脏	ueug
臃	uewa
服务	uewl
胲	uewr
服	ueyh
鲰	ueyt
膀子	uezw
脑子	uezw
胜	uf
胙	ufae
霉菌	ufck
胜负	ufdb
胜于	ufeg
霉烂	ufhb
肪	ufhg
腹面	ufhp
腹部	uflk
霉	ufmd
胜利	ufpm
胜任	ufrp
腹	ufrw
鳆	ufrw
鲂	uftg
胜	ufth
肠	ug
霸占	ugah
臁	ugbb
霸道	ugbh
甩	ugh
肛	ughh
肠炎	ughh
鳙	ugio
鳓	uglt
肛门	ugmd
霸权	ugmy
肠	ugpp
鲺	ugpv
腑	ugrc
脏	ugth
霸	ugud
肠子	ugzw
需	uh
雨	uhag
鲆	uhbo
腻	uhed
雨天	uher
胰	uhgr
需求	uhhg
雨衣	uhid
肺	uhjh
膈	uhka
鲡	uhkd
需	uhpa
鲕	uhpa
颥	uhpb
腼	uhph
雨季	uhpm
豚	uhpn
胚	uhrh
雨量	uhrh
鲠	uhri
雨水	uhsg
腈	uhtu
鲭	uhtu
膊	uhuc
脯	uhud
腼腆	uhuk
胚胎	uhus
肫	uhwg
胨	uhwx
需要	uhxn
腻子	uhzw
雪	ui
雪白	uibp
雪花	uicr
鲟	uict
雪	uidh
雪亮	uiek
腱	uiez
鲫	uige
腿	uigz
脎	uihx
雪山	uioa
雪崩	uiou
鲫鱼	uiup
腿脚	uiut
股	uj
霓	ujed
鲵	ujet
肌	ujhg
股东	ujhw
肌肉	ujkr
股份	ujrb
腴	ujrh
肌体	ujrm
股长	ujvp
股票	ujxo
股	ujyh
露	uk
肿	ukah
露	ukak
雪中送炭	ukbo
腆	ukcb
鳢	ukcd
胭	ukdh
露天	uker
肿瘤	ukgl
胴	ukhk
露面	ukhp
酃	ukkd
腭	ukkg
鳄	ukkg
臊	ukkm
脶	ukkr
鲴	ukoh
肭	ukrh
露水	uksg
胭脂	ukub
露出	ukwa
脚踏实地	ukxt
肋	ul
胁	ulbh
脑力劳动	ulce
肋	ulhp
肋骨	ulkw
霎	ulnd
臆	ulrx
霜	um
膝盖	umbw
霸权主义	umed
霜冻	umlh
霖	ummd
霜	ummd
膝	umrd
肢	uo
鲼	uocb
膨大	uodh
膨	uodp
臌	uody
胧	uogd
鱿	uogd
鲒	uohk
霹	uoko
腩	uoko
肢体	uorm
肱	uosh
脲	uosh
脖	uotz
鲔	uout
膨胀	uouv
霹雳	uouv
胸有成竹	uova
鲅	uoyd
肢	uoyh
脖子	uozw
月	up
鱼类	upbm
月色	updb
霾	updt
月刊	upea
月亮	upek
胝	upgd
鲷	upgk
月底	upgp
月	uphg
月初	upid
鱼群	upik
鲧	upjt
月中	upka
鱼肉	upkr
鳅	upmh
稣	upmt
鱼苗	upoc
霆	upoz
鱼种	uppm
胍	uppn
肜	uppp
月份	uprb
鱼池	upsg
月台	upsk
鱼	upwa
月球	upwh
月光	upxh
肷	uqhn
脸	ur
胛	urah
胂	urah
零点	urah
零售	urak
鲲	urbb
脸盆	urbd
零散	urch
鲁莽	urcq
鲋	urct
鲥	urct
脸色	urdb
零	urdd
胆大	urdh
鲶	urdx
脍	ures
腥	urft
鳎	urgl
脸庞	urgo
脸颊	urhb
腧	urhd
胆	urhh
脸	urhh
鲁	urhh
腽	urmh
零碎	uroe
胗	urpp
零星	urrf
胆量	urrh
零件	urrn
脞	urrt
鲳	urrt
胆汁	urso
鳗	ursy
鲤	urtt
胆略	urtw
鲤鱼	urup
鲥鱼	urup
胆敢	urwe
胆小	urxg
胆怯	urxt
鳏	usad
霪	usah
胎儿	usep
霈	ushj
胎	uskh
鲐	uskt
腠	usrd
脚	ut
脚步	utaa
鲮	utbw
雷	utdh
雷达	utdz
肚皮	utgp
脚下	utha
肚	uthh
脓	utih
脚跟	utka
脚趾	utka
雷声	utoh
鳍	utpr
雷电	utrg
脚	utse
鲑	uttt
雷雨	utuh
脚尖	utxd
腮	utxh
鳃	utxt
脚掌	utxt
肚子	utzw
朋	uu
朋	uuhh
鳕	uuit
鹏	uunh
零零碎碎	uuoo
朋友	uuoy
震	uv
震荡	uvcs
震	uven
震动	uves
鳜	uvgq
胀	uvhn
雳	uvld
震惊	uvxe
震憾	uvxv
鲢	uvzt
雾	uw
胫	uwdg
服务态度	uwdg
雯	uwdn
鲦	uwhx
霞	uwhy
服务员	uwkb
胳	uwkh
雾	uwld
脐	uwpa
霁	uwpa
鲚	uwpa
雾气	uwqp
雾滴	uwse
胳膊	uwuh
鲻	uwwt
霞光	uwxh
腰	ux
腰包	uxds
脘	uxee
鲩	uxee
腔	uxgh
胱	uxhe
腚	uxhr
膣	uxht
腰部	uxlk
胺	uxnh
腰	uxnh
膘	uxoh
腙	uxoh
鳔	uxot
膑	uxpb
膛	uxtt
霄	uxud
腕	uxxg
腔调	uxyp
鲜	uy
膳	uybk
鳝	uybk
鲜美	uybw
鲜花	uycr
鳋	uydv
鲜红	uyjg
鲜嫩	uynh
鲜血	uypm
鲜明	uyru
霭	uyrw
鲜艳	uysa
鲜	uyta
出	v
虫	va
顾此失彼	vafp
戚	vahd
虾	vahd
轳	vaho
蹙	vahr
蛳	vapj
虫	vawh
虫害	vaxs
蜉	vazd
虫子	vazw
原	vb
蚍	vbbd
原则	vbbd
原料	vbbm
原著	vbct
厕	vbdp
蜷	vbeg
愿望	vbeg
原告	vbfa
原先	vbfa
原来	vbhb
原煤	vbhc
劂	vbhd
厥	vbhq
原因	vbkd
蜕	vbke
原形	vbkp
原状	vbla
原意	vblr
愿意	vblr
辚	vbma
原棉	vbmb
原本	vbmh
原木	vbmh
蝼	vbmn
原样	vbmy
原始	vbns
原有	vbou
原版	vbpa
原稿	vbpm
蜱	vbpo
厕所	vbpp
蝉	vbro
蜕化	vbrq
原野	vbrt
蚣	vbsd
蜣	vbsg
原油	vbsk
原地	vbtg
蝗虫	vbva
蝗	vbwd
原文	vbwd
原理	vbwr
原	vbxp
愿	vbxx
蝤	vbyd
原谅	vbye
原子	vbzw
蜡	vc
蠖	vcay
蚶	vced
蟥	vchb
蝶	vchm
蜡	vchr
厝	vchr
螨	vchr
蜡烛	vchv
蟒	vcqc
蟆	vcrd
蜞	vcsb
蠛	vcsd
厮	vcsj
蝾	vctm
蠓	vctn
厨师	vdap
厨	vdcp
蚪	vddo
厨房	vddo
轫	vddt
戍	vdgd
蚁	vdid
螂	vdie
蟓	vdkn
轺	vdkt
蝙	vdoc
蝰	vdtt
蟾	vdvy
厨子	vdzw
较	ve
转业	veaa
转战	veah
转盘	veam
轩	veat
转送	vebe
螃	vebf
较	vebi
蛟	vebi
转账	vebv
较大	vedh
较为	vedl
转为	vedl
转达	vedz
转变	veea
转弯	veea
转交	veeb
转动	vees
转运	vees
转告	vefa
辱	vegc
唇	vegk
较强	vegk
较弱	vegl
辰	vegn
辄	vegt
蜃	vegv
转炉	vehd
转速	vehk
转而	vehp
螭	veis
辱骂	vekk
转眼	vemi
转机	vemj
较好	venz
转换	veod
转折	veoj
转播	veop
转身	veop
长远利益	vepb
转向	vepk
转移	vepm
转入	vepn
蚨	verd
较量	verh
转化	verq
辙	vesw
较坏	veth
转轴	vevk
转	vewd
虻	vewd
蟀	vewo
转发	vewp
较小	vexg
较少	vexp
较多	vexx
转让	veya
转子	vezw
蚱	vfae
蜘	vfdk
轶	vfdt
蝣	vffz
虼	vfgd
蝮	vfrw
蜘蛛	vfvn
成	vg
轻工业	vgaa
顾虑	vgah
轻工业部	vgal
蠊	vgbb
成分	vgbd
成败	vgbw
虬	vgd
虹	vgdh
成套	vgdh
盛大	vgdh
成为	vgdl
成交	vgeb
成效	vgeb
成就	vgek
成熟	vgek
成规	vger
成天	vger
成年	vgfh
轧制	vgfh
顾	vggb
成	vggd
成功	vggl
盛	vggm
厄	vggp
盛夏	vghp
螗	vgik
成群	vgik
成绩	vgjh
成员	vgkb
成型	vgkd
成因	vgkd
盛开	vgkh
成品	vgkk
成见	vgkp
虹吸	vgkp
蚓	vgld
成立	vgld
盛况	vglk
盛产	vglp
成本	vgmh
成材	vgmh
轧机	vgmj
顾问	vgmk
成批	vgob
戊	vgpd
盛行	vgpr
盛会	vgre
成倍	vgrl
成果	vgrm
成人	vgrp
成全	vgrw
顾全	vgrw
成活	vgsp
轧染	vgsp
轧	vgt
成都	vgtp
成虫	vgva
成长	vgvp
轧辊	vgvr
辘	vgwb
成心	vgxd
盛情	vgxh
成名	vgxk
顾客	vgxw
成语	vgyh
厂	vh
感受	vhat
咸菜	vhca
感觉	vhdb
车刀	vhdg
厂房	vhdo
感触	vhdu
威武	vhea
厂商	vheb
威望	vheg
车队	vher
咸阳	vher
感动	vhes
感知	vhfd
感生	vhft
戌	vhgd
轼	vhgd
感应	vhgd
蛲	vhge
车工	vhgh
车床	vhgm
厅	vhgp
车库	vhgv
威严	vhha
车灯	vhhh
车速	vhhk
威逼	vhhk
感到	vhhs
威风	vhji
咸	vhkd
蜮	vhkd
轲	vhkg
蚵	vhkg
辆	vhkr
螬	vhkr
辅助	vhks
辐	vhkt
蝠	vhkt
感	vhkx
感叹	vhky
车站	vhla
威力	vhlg
车次	vhlq
车门	vhmd
厦门	vhmd
感想	vhmm
车间	vhmr
威	vhnd
车把	vhob
辐射	vhoc
厂矿	vhog
车祸	vhok
车身	vhop
厂	vhp
车牌	vhpa
厉	vhpg
励	vhpl
厦	vhpw
轻而易举	vhrd
感冒	vhrm
感人	vhrp
蟪	vhrx
威信	vhry
感激	vhsb
辅导	vhsc
感染	vhsp
轾	vhst
蛭	vhst
厂址	vhta
辅	vhud
威胁	vhul
蚜虫	vhva
车辆	vhvh
车厢	vhvm
厂长	vhvp
车轮	vhvr
车	vhwh
蚜	vhwp
感性	vhxf
厂家	vhxh
感光	vhxh
感情	vhxh
感慨	vhxi
车票	vhxo
厉害	vhxs
感官	vhxw
感谢	vhyo
厂子	vhzw
车子	vhzw
厩	vi
厩	vigg
暂	vj
螋	vjay
虮	vjdg
暂缓	vjja
錾	vjjt
暂且	vjks
椠	vjmt
连锁反应	vjpg
暂行	vjpr
暂时	vjrc
暂停	vjre
暂	vjrt
斩	vjta
堑	vjtt
暂定	vjxh
轴	vk
軎	vkah
轴箱	vkam
轵	vkbt
辋	vkbw
蛐	vkch
轴套	vkdh
蜈	vker
辑	vket
成品率	vkew
轴瓦	vkhg
轴线	vkje
历史唯物主义	vkkd
历史唯心主义	vkkd
蛔	vkkh
蜗	vkkr
轴	vkoh
蚰	vkoh
蜗牛	vkow
蚬	vkpg
蚋	vkrd
蝇	vkrg
蛆	vksd
蚺	vktd
蝈	vkwh
轴心	vkxd
轴承	vkze
历	vl
历年	vlfh
历来	vlhb
历史	vlki
历次	vllq
历程	vlpm
历	vlpp
历时	vlrc
历代	vlrh
蟑	vlro
历法	vlst
历历	vlvl
蚝	vmdg
蛊	vmdh
蚂	vmdh
蜥	vmjd
成本核算	vmma
厢	vmmp
蠼	vmmy
蚂蚁	vmvd
蚂蚱	vmvf
蛛	vn
蛛	vnbd
辗	vo
辗	vocn
蟛	vodp
蛄	vokd
蝻	voko
轱	vokt
蝴	voku
轻描淡写	vost
蝴蝶	vovc
辗转	vove
长	vp
舆	vpab
长篇	vpad
蚯	vpag
成千上万	vpah
蜒	vpaz
轷	vpbg
轨道	vpbh
蟠	vpbt
蟋	vpbx
长期	vpcs
轿	vpda
长大	vpdh
长久	vpdn
长远	vpee
轨迹	vpep
长短	vpfd
长年	vpfh
长度	vpgc
长工	vpgh
蜩	vpgk
轨	vpgt
长	vphg
轻重缓急	vpjd
长跑	vpka
蜊	vpmd
蝌	vpmo
螅	vpmx
长存	vpoa
蛾	vpod
蛞	vpok
长势	vpop
蜓	vpoz
长征	vppr
长途	vpre
长波	vpsg
长江	vpsg
长春	vpsr
长沙	vpsx
长城	vptv
蟋蟀	vpve
长虹	vpvg
蚯蚓	vpvg
轿车	vpvh
长处	vpwa
轹	vpwx
长安	vpxn
舆论	vpyr
长子	vpzw
软	vq
软盘	vqam
魇	vqbs
软弱	vqgl
厌恶	vqha
靥	vqhh
厌烦	vqhh
软骨	vqkw
盛气凌人	vqlr
餍	vqop
厌	vqpd
厣	vqra
厌倦	vqrb
软件	vqrn
软化	vqrq
软	vqtn
轮	vr
赝	vrab
轮船	vraj
辊	vrbb
输送	vrbe
厘米	vrbm
轮	vrbt
厚薄	vrcs
蛉	vrdd
蜴	vrdp
蝎	vrdw
蜍	vrex
厚度	vrgc
轮廓	vrge
输	vrhd
蝓	vrhd
蛤	vrhk
蜾	vrmd
轮机	vrmj
轮换	vrod
蚧	vrpa
厘升	vrpc
仄	vrpn
输入	vrpn
轸	vrpp
轮作	vrrf
输电	vrrg
轮流	vrse
厘	vrtp
轮胎	vrus
轮轴	vrvk
输出	vrwa
辁	vrwt
轮训	vryp
厚	vrzp
轮子	vrzw
蚌	vs
蚌	vsad
长春市	vsej
长沙市	vsej
蛑	vsnd
辏	vsrd
螓	vsrm
蝽	vsrr
压	vt
压迫	vtbz
压	vtdp
成都市	vtej
螺旋	vtff
压制	vtfh
压强	vtgk
螺	vtjd
螺钉	vtjh
螺帽	vtjr
螺纹	vtjw
压缩	vtjx
螺距	vtka
辕	vtki
压力	vtlg
螺栓	vtmr
螺母	vtmw
压榨	vtmx
压抑	vtop
螟	vtrb
压倒	vtrh
压低	vtrp
蛙	vttd
螺丝	vtww
蠕	vu
蠕动	vues
蠕	vuha
螈	vvbx
轭	vvgg
蛎	vvhg
轰轰烈烈	vvhh
厍	vvpa
轻	vw
墼	vwat
轻蔑	vwcs
轻	vwdg
蚊	vwdn
蛹	vwdo
轻率	vwew
轻工	vwgh
轻巧	vwgh
臧	vwhd
蜂群	vwik
辂	vwkt
轻松	vwmb
轻声	vwoh
轻视	vwok
蜂拥	vwou
蛴	vwpa
轻重	vwph
轻微	vwpr
轻易	vwrd
轻便	vwrh
轻信	vwry
蜂	vwsa
蚴	vwsl
轻轻	vwvw
蜂王	vwwh
辎	vwwt
蜂蜜	vwxd
轻快	vwxw
蚊子	vwzw
蛇	vx
蛇	vxbd
螵	vxod
辖	vxsk
顾名思义	vxtd
螳	vxtt
蛸	vxud
蜿蜒	vxvp
蜿	vxxg
感性认识	vxyy
轰	vy
蟮	vybk
蛘	vyda
轰击	vyeo
轰动	vyes
轰炸	vyhf
蛏	vytd
轰	vyya
辍	vyyy
连	vzan
连队	vzer
连夜	vzer
连年	vzfh
连绵	vzjb
连续	vzjo
连锁	vzjx
连同	vzkh
蜢	vzmd
连杆	vzme
连声	vzoh
连接	vzol
连日	vzra
原子能	vzsu
连累	vztj
连长	vzvp
连连	vzvz
连贯	vzww
连心	vzxd
连忙	vzxe
为	w
处	wa
凵	wa
屮	waa
璞	waad
出售	waak
出师	waap
蚩	waav
处分	wabd
出勤	wach
出世	wach
处世	wach
疏散	wach
出色	wadb
出头	wadd
眉头	wadd
出奇	wadh
咎	wadk
处	wadn
疏忽	wadp
昝	wadr
疏远	waee
疏	waeg
出于	waeg
处于	waeg
出击	waeo
出动	waes
出院	waex
瑗	waey
瑶	waft
出生	waft
出席	wagc
出工	wagh
出庭	wagp
出来	wahb
奘	wahd
戕	wahg
琥	wahj
玷	wahk
出事	wahk
眉	wahm
璨	wahm
璩	wahn
鹛	wahn
爿	wahp
出面	wahp
处死	wahx
出错	wajc
出纳	wajk
出口	waka
出路	waka
出品	wakk
出国	wakw
出力	walg
出产	walp
处决	walw
眉目	wama
疏松	wamb
出门	wamd
眉毛	wamp
出马	wamw
出嫁	wanx
出	wao
出卖	waog
粜	waom
祟	waoo
出身	waop
出手	waop
出神	waor
出版	wapa
出兵	wapa
出乎	wapb
出息	wapm
出血	wapm
出租	wapm
出入	wapn
处所	wapp
出气	waqp
出任	warp
弄虚作假	warr
齑	wasa
玷污	wase
出海	wasf
疏水	wasg
出没	wasj
处置	waso
处罚	wasy
出场	watg
出土	wath
出境	watl
处境	watl
出去	wats
瑷	waty
出厂	wavh
处长	wavp
处处	wawa
疏通	wawd
出现	wawk
出发	wawp
处理	wawr
出家	waxh
出名	waxk
出差	wayg
出走	wazh
碧	wb
璎	wbbn
玢	wbdt
瑰丽	wbhk
碧绿	wbjw
碧	wbot
瑰	wbps
各单位	wbrl
碧波	wbsg
珀	wbth
弄	wc
弄	wcha
珙	wchb
璜	wchb
瑾	wcht
瑛	wckd
琪	wcsb
弄清	wcsh
文	wd
通航	wdae
文集	wdam
预算	wdam
齐头并进	wdbe
柔道	wdbh
通道	wdbh
玉米	wdbm
预料	wdbm
文艺	wdcg
预期	wdcs
通过	wdcz
文学	wddb
劲头	wddd
矛头	wddd
刘	wddg
冬	wddn
螽	wddv
登陆	wdee
预防	wdef
勇于	wdeg
冬天	wder
文盲	wdew
玩忽职守	wdex
通告	wdfa
文告	wdfa
预告	wdfa
预先	wdfa
预选	wdfa
通知	wdfd
预制	wdfh
颈	wdgb
预	wdgb
刭	wdgd
予以	wdgd
予	wdgg
巯	wdgg
鍪	wdgj
劲	wdgl
柔	wdgm
骛	wdgm
瞀	wdgm
豫	wdgn
婺	wdgn
鹜	wdgn
鹬	wdgn
矛	wdgp
蝥	wdgv
蟊	wdgv
矜	wdgw
迳	wdgz
玉	wdh
琦	wdhg
柔韧	wdhh
文	wdhp
文雅	wdhw
琅	wdin
预约	wdjd
通红	wdjg
通风	wdji
文风	wdji
班组	wdjk
班级	wdjp
通路	wdka
文史	wdki
预见	wdkp
文具	wdks
班次	wdlq
文章	wdlr
班机	wdmj
预想	wdmm
文物	wdnd
玖	wdnt
登山	wdoa
登报	wdoe
通报	wdoe
预报	wdoe
勇士	wdoh
玉石	wdoh
预示	wdoh
文献	wdok
预祝	wdok
预热	wdop
通顺	wdpa
登	wdpd
癸	wdpd
凳	wdpj
预兆	wdpl
冬季	wdpm
柔和	wdpm
通称	wdpm
冬瓜	wdpp
矛盾	wdpp
通往	wdpr
通行	wdpr
班	wdpw
通气	wdqp
勇气	wdqp
勇猛	wdqx
通畅	wdra
通俗	wdrb
通电	wdrg
文体	wdrm
文件	wdrn
文凭	wdrp
文人	wdrp
文化	wdrq
文明	wdru
通信	wdry
预测	wdsb
登台	wdsk
文法	wdst
各大军区	wdth
文教	wdtp
登载	wdtv
甬	wdua
通用	wdua
勇	wdul
恿	wdux
通	wduz
班车	wdvh
通车	wdvh
预感	wdvh
班长	wdvp
柔软	wdvq
登录	wdwe
勇敢	wdwe
文书	wdwg
预备	wdwt
预定	wdxh
通常	wdxt
文字	wdxz
预谋	wdyc
文言	wdyd
预言	wdyd
通讯	wdyg
预订	wdyh
登记	wdyj
预计	wdyo
班子	wdzw
凳子	wdzw
敢	we
赟	weab
斌	wead
民主集中制	weaf
玩笑	weap
玩艺	wecg
剥夺	wedc
敢于	weeg
玩	weet
录取	weey
剥	wegd
录	wegn
逯	wegz
玩耍	wehp
璃	weis
幼儿园	weke
玩具	weks
琼	wekx
录音	welr
发动机	wemj
敢想	wemm
这就是说	wery
琉	wesg
珥	weth
敢	wew
玩弄	wewc
憨	wewx
民主党派	wexs
剥削	wexu
瓒	wfab
璇	wffr
了	wg
书	wgad
书桌	wgah
书籍	wgas
函数	wgbm
预收账款	wgbo
眉飞色舞	wgdf
书房	wgdo
书包	wgds
了解	wgdu
书刊	wgea
了望	wgeg
书店	wgga
书面	wghp
瑭	wgik
亟	wgkh
函	wgla
书目	wgma
书本	wgmh
辽阔	wgms
孓	wgn
毋	wgo
函授	wgoa
书报	wgoe
玻	wgpy
书信	wgry
书法	wgst
孑	wgt
书写	wgth
玻璃	wgwe
辽宁	wgxh
书记	wgyj
辽	wgz
已	wh
民航	whae
遐	whaz
王爷	whbi
王公	whbs
民警	whcd
环节	whcg
球队	wher
民主	whet
已知	whfd
民族	whff
民生	whft
已	whg
球	whgd
民	whgg
民工	whgh
琢磨	whgm
玎	whgt
愍	whgx
王	whha
玮	whha
民政	whha
民歌	whhk
民事	whhk
球面	whhp
琰	whht
条约	whjd
环绕	whjh
条纹	whjw
已经	whjw
珂	whkg
环形	whkp
球形	whkp
民国	whkw
王国	whkw
球状	whla
民办	whlb
民政部	whlk
民意	whlr
条目	whma
球门	whmd
民间	whmr
民权	whmy
王权	whmy
环抱	whod
环视	whok
王朝	whor
条款	whos
斋	whpa
民兵	whpa
顼	whpb
琢	whpn
环	whrd
理事会	whre
条例	whrh
环保	whrk
球果	whrm
球体	whrm
条件	whrn
民众	whrr
环流	whse
民法	whst
环境	whtl
民用	whua
环顾	whvg
条文	whwd
琊	whwe
环球	whwh
各式各样	whwm
条理	whwr
逄	whwz
民心	whxd
条	whxn
条子	whzw
王子	whzw
紊	wj
紊	wjnd
紊乱	wjpo
各级领导	wjrs
玑	wjtg
各级党委	wjxp
现	wk
雒	wkad
璐	wkak
各类	wkbm
现象	wkdk
各族	wkff
各项	wkgh
各级	wkjp
现金	wkjp
各国	wkkw
现状	wkla
眉开眼笑	wkma
各样	wkmy
各	wknh
吝	wknh
现存	wkoa
现在	wkoa
现有	wkou
现	wkpg
各种	wkpm
各自	wkpm
现行	wkpr
现时	wkrc
现今	wkrd
现代	wkrh
各位	wkrl
各地	wktg
现场	wktg
髅	wktn
各界	wktr
现成	wkvg
各处	wkwa
现实	wkxd
务	wl
务必	wldg
翠绿	wljw
珈	wlkt
务	wlnp
璋	wlro
民意测验	wlsm
翟	wlwa
翼	wlwb
羿	wlwc
戳	wlwg
戮	wlwg
翌	wlwl
鹨	wlwn
翠	wlwo
戳穿	wlxh
琳	wm
斓	wmhb
琳	wmmt
玛	wmth
玛瑙	wmww
珠	wn
珠算	wnam
珠	wnbt
了如指掌	wnox
珠海	wnsf
珠江	wnsg
珠宝	wnxw
瑞	wo
璀	woat
珑	wogd
瑞	woha
瑞典	wokc
瑚	woku
发展中国家	wokx
瑞士	wooh
琚	wook
各尽所能	wops
理直气壮	woql
发扬光大	woxd
剂	wp
剂	wpad
齐	wpan
发送	wpbe
发财	wpbh
发白	wpbp
发芽	wpch
各行其事	wpch
发觉	wpdb
各自为政	wpdh
发达	wpdz
发亮	wpek
发动	wpes
发育	wpes
发生	wpft
发放	wpfw
珊	wpgh
发病	wpgl
发疯	wpgl
发火	wphd
发烧	wphh
发炎	wphh
攵	wphp
发表	wpht
发给	wpjr
发呆	wpkm
璁	wpkx
珧	wpld
发音	wplr
发怒	wpny
发射	wpoc
发展	wpoc
发抖	wpod
发报	wpoe
发扬	wpog
发声	wpoh
发布	wpoj
发誓	wpoj
发掘	wpoo
发热	wpop
贯彻执行	wpop
发挥	wpot
出版社	wpot
发愁	wppm
发行	wppr
发作	wprf
珩	wprg
发电	wprg
剂量	wprh
发货	wprq
发明	wpru
齐全	wprw
发泄	wpsc
发源	wpsv
出租汽车	wpsv
发霉	wpuf
发出	wpwa
发球	wpwh
发现	wpwk
各种各样	wpwm
夂	wpwn
珊瑚	wpwo
齐备	wpwt
发慌	wpxc
发光	wpxh
发情	wpxh
发怵	wpxm
发愤	wpxo
发票	wpxo
理所当然	wpxx
发	wpyd
发言	wpyd
发酵	wpyt
发起	wpzj
琨	wrbb
预付账款	wrbo
玲	wrdd
理解	wrdu
理智	wrfd
玳	wrhd
瑜	wrhd
理事	wrhk
珍贵	wrka
理由	wrko
理睬	wrma
发电机	wrmj
理想	wrmm
瑁	wrmt
文化娱乐	wrnp
条件反射	wrpo
珍	wrpp
理会	wrre
发明创造	wrrf
现代化	wrrq
理	wrtt
通信地址	wrtt
玲珑	wrwo
理发	wrwp
珍惜	wrxc
理性	wrxf
通俗读物	wryn
理论	wryr
幼	ws
逢	wsaz
幺	wsd
幻觉	wsdb
幼儿	wsep
幼年	wsfh
幻	wsg
丞	wsh
卺	wshg
幻灯	wshh
幼	wsl
幻想	wsmm
幼林	wsmm
丞相	wsmm
幼苗	wsoc
幼稚	wspm
幼体	wsrm
幼虫	wsva
畿	wswd
幼小	wsxg
备	wt
备战	wtah
琛	wtbm
备料	wtbm
丑态	wtdd
丑陋	wteh
环境卫生	wtgf
丑	wth
丑恶	wtha
丑闻	wtme
备	wtnh
丑剧	wtoo
备份	wtrb
备件	wtrn
丑化	wtrq
备耕	wtsa
备注	wtse
珐	wtst
备用	wtua
珲	wtvt
惫	wtxn
备案	wtxn
备课	wtyr
琏	wvzt
乡	ww
斑点	wwah
琵	wwbb
琶	wwbh
斑白	wwbp
巡警	wwcd
瑟	wwdd
珏	wwdt
丝毫	wwek
彝族	wwff
乡下	wwha
彘	wwhb
彝	wwhc
珉	wwhg
丝束	wwhk
彖	wwhn
蠡	wwhv
瑕	wwhy
丝线	wwje
乡镇	wwjo
丝绸	wwjp
贯串	wwkk
巡回	wwkk
珞	wwkt
丝状	wwla
乡亲	wwlh
乡村	wwmc
乡间	wwmr
巡查	wwmr
贯	wwob
巡抚	wwoe
巡视	wwok
乡	wwp
飨	wwpo
贯彻	wwpr
乡里	wwrt
琴	wwrw
贯注	wwse
巡逻	wwsx
玫	wwtn
玟	wwtn
乡长	wwvp
巛	www
邕	wwwb
玫瑰	wwwb
剿	wwwd
贯通	wwwd
丝	wwwh
瑙	wwwh
巢	wwwm
鸶	wwwn
斑	wwwt
甾	wwwt
巡	wwwz
邋	wwwz
贯穿	wwxh
丝光	wwxh
琐	wx
琐	wxbt
通情达理	wxdw
现实意义	wxld
琐碎	wxoe
齐心协力	wxol
琮	wxot
琬	wxxg
辽宁省	wxxp
出谋划策	wyga
通讯卫星	wygr
发言人	wyrp
书记处	wywa
这	wz
这些	wzab
这般	wzaj
这	wzdn
这儿	wzep
这样	wzmy
这种	wzpm
这么	wzps
这个	wzra
这是	wzrh
这里	wzrt
下	x
外	xa
悭	xaat
外	xadd
忄	xadd
外头	xadd
雀	xadh
惟	xadh
外套	xadh
外交	xaeb
外商	xaeb
外弦	xage
外来	xahb
憔	xahd
悼	xaho
外面	xahp
寂静	xaht
外表	xaht
寂	xahy
外衣	xaid
外销	xajx
外因	xakd
外号	xakh
外围	xakh
外形	xakp
外国	xakw
外力	xalg
外部	xalk
外加	xalk
外资	xalq
外边	xalz
外间	xamr
外存	xaoa
外在	xaoa
外壳	xaoh
外貌	xapd
外贸	xapg
外科	xapm
外行	xapr
悼念	xard
外电	xarg
外人	xarp
外流	xase
外婆	xasg
外汇	xash
悱	xass
外地	xatg
外界	xatr
外长	xavp
外出	xawa
外文	xawd
外务	xawl
寂寞	xaxc
憔悴	xaxe
外宾	xaxp
外省	xaxp
悼词	xayg
外语	xayh
外设	xayj
外观	xayk
它	xb
恻	xbdd
怕	xbdh
悦耳	xbeh
它	xbgg
惶恐	xbgj
悌	xbgp
慊	xbhb
贾	xbhd
惶惑	xbhk
邃	xbhz
悦	xbke
憎	xbkr
粟	xbmh
窭	xbmn
愧	xbps
它们	xbrm
惮	xbro
忪	xbsd
惶	xbwd
少数民族	xbwf
憎恨	xbxi
懂	xc
守旧	xcar
守则	xcbd
忖	xcdd
宽大	xcdh
慌	xceg
守卫	xcga
宽度	xcgc
守	xcgd
宽广	xcgd
慌张	xcgv
懂事	xchk
惜	xchr
宽	xckg
宽阔	xcms
宽恕	xcnk
守护	xcod
宽慰	xcoo
西藏自治区	xcph
慌乱	xcpo
懂得	xcpr
懂	xcpt
寞	xcrd
懵	xcsm
守法	xcst
宽厚	xcvr
慌忙	xcxe
宽窄	xcxf
宽敞	xcxk
心	xd
实业	xdaa
密集	xdam
心爱	xdat
然则	xdbd
实数	xdbm
寮	xdbx
实	xddd
心头	xddd
穴	xddg
宀	xddg
尖刀	xddg
心急	xddi
尖	xddn
心房	xddo
忉	xddp
实干	xdea
实际	xdeo
实施	xdff
寄生	xdft
小学生	xdft
密度	xdgc
心	xdgd
宓	xdgd
实习	xdgl
心疼	xdgl
密	xdgo
蜜	xdgv
炙	xdhd
寄	xdhg
心事	xdhk
然而	xdhp
实惠	xdhr
心灵	xdih
尖锐	xdjb
心绪	xdjt
实践	xdka
心中	xdka
怊	xdkd
实力	xdlg
尖端	xdlo
心意	xdlr
心目	xdma
密闭	xdmh
心机	xdmj
密植	xdmo
实验	xdmr
实物	xdnd
实在	xdoa
密布	xdoj
密码	xdom
寄托	xdop
心神	xdor
心血	xdpm
然后	xdpp
实质	xdpp
实行	xdpr
心得	xdpr
惚	xdpx
密切	xdqd
然	xdqh
恂	xdrd
实例	xdrh
穴位	xdrl
实体	xdrm
密件	xdrn
心里	xdrt
密信	xdry
实地	xdtg
心境	xdtl
心坎	xdtq
密封	xdtt
心思	xdtx
实用	xdua
心胸	xdud
心肠	xdug
心脏	xdug
心愿	xdvb
蜜蜂	xdvw
寄予	xdwd
实现	xdwk
祭	xdwo
心理	xdwr
尜	xdxd
心情	xdxh
心室	xdxh
心计	xdyo
实话	xdyp
完	xe
忭	xead
宇航	xeae
完毕	xebb
惊疑	xebf
完美	xebw
惊奇	xedh
完	xeeg
惊险	xeer
惊动	xees
惊天动地	xeet
寇	xeey
宇	xegg
完工	xegh
惊恐	xegj
恼火	xehd
完事	xehk
完整	xehk
恼	xeia
完结	xejo
懔	xeko
惊	xekx
惊叹	xeky
外交部	xelk
恼怒	xeny
完好	xenz
惊喜	xeod
忙碌	xeow
怃	xepg
忙乱	xepo
窥	xerg
悴	xero
惊人	xerp
完全	xerw
惊异	xesc
恸	xesl
完成	xevg
忙	xewd
窿	xewt
完备	xewt
惊慌	xexc
宇宙	xexk
实际情况	xexl
完善	xeyb
惊讶	xeyh
惊醒	xeyr
惊诧	xeyx
慑	xeyy
宪	xfae
窄	xfae
怍	xfae
窖	xfak
窑	xfda
性急	xfdi
少先队员	xfek
少年儿童	xfel
少先队	xfer
宪政	xfha
性别	xfkl
西方国家	xfkx
宪章	xflr
悔	xfmd
性格	xfmw
忤	xfod
宪兵	xfpa
性质	xfpp
性命	xfrh
愎	xfrw
窑洞	xfsk
宪法	xfst
性能	xfsu
性	xftd
性情	xfxh
悔恨	xfxi
性子	xfzw
小	xg
空虚	xgah
小船	xgaj
惦	xgak
小辈	xgas
小弟	xgbg
空前	xgbh
小米	xgbm
小数	xgbm
空白	xgbp
小鬼	xgbp
小节	xgcg
忆	xgd
小学	xgdb
空头	xgdd
穹	xgdg
空	xgdh
小于	xgeg
小队	xger
空运	xges
空隙	xgex
小工	xggh
眢	xggm
鸳	xggn
怨	xggx
窍	xghg
小麦	xght
慷	xgin
慵	xgio
小组	xgjk
小结	xgjo
空中	xgka
小型	xgkd
鸳鸯	xgkd
空闲	xgmm
空想	xgmm
空间	xgmr
空格	xgmw
小姐	xgnk
小姑	xgno
小鸟	xgnp
小指	xgob
空投	xgoj
怫	xgpa
小	xgpd
突飞猛进	xgqe
空气	xgqp
小气	xgqp
小时	xgrc
惦念	xgrd
空旷	xgrg
空位	xgrl
小人	xgrp
小偷	xgrr
小溪	xgsa
小河	xgsh
空洞	xgsk
空地	xgtg
小写	xgth
小农	xgti
空军	xgtv
小肠	xgug
小腿	xgui
小车	xgvh
家庭出身	xgwo
空心	xgxd
空穴	xgxd
小心	xgxd
小小	xgxg
慷慨	xgxi
怨恨	xgxi
小说	xgyb
怨言	xgyd
空谈	xgyh
惦记	xgyj
空调	xgyp
空话	xgyp
小孩	xgze
小子	xgzw
家	xh
光临	xhaa
怔	xhad
西北	xhae
定点	xhah
西餐	xhah
宣战	xhah
悟	xhak
光彩	xham
定	xhar
宁肯	xhau
宦	xhaw
西	xhaw
情分	xhbd
家眷	xhbe
怀疑	xhbf
怦	xhbo
赛	xhcb
寒	xhcd
光芒	xhce
灾荒	xhce
情节	xhcg
褰	xhci
骞	xhcm
搴	xhco
蹇	xhcr
定期	xhcs
塞	xhct
光荣	xhct
西藏	xhcv
寨	xhcx
名副其实	xhcx
謇	xhcy
光学	xhdb
定义	xhdi
家兔	xhdk
耀	xhea
完整无缺	xhef
富于	xheg
光亮	xhek
光	xhep
光阴	xheu
辉	xhev
宣告	xhfa
西方	xhfd
家族	xhff
光复	xhfr
定弦	xhge
宁	xhgg
富强	xhgk
灾	xhgn
怀孕	xhgp
家庭	xhgp
西皮	xhgp
西亚	xhha
辉煌	xhhb
西医	xhhf
西欧	xhhi
灾区	xhhi
宁可	xhhk
宁夏	xhhp
西面	xhhp
西夏	xhhp
实事求是	xhhr
宁静	xhht
惬	xhhw
富裕	xhib
怄	xhiw
光缆	xhja
光线	xhje
寒风	xhji
西风	xhji
光绪	xhjt
情绪	xhjt
富贵	xhka
赛跑	xhka
懒	xhkb
寅	xhkb
悚	xhkb
定员	xhkb
光圈	xhkb
定型	xhkd
家园	xhke
宁夏回族自治区	xhkh
定形	xhkp
情形	xhkp
室内	xhkr
家具	xhks
富	xhkt
寒喧	xhkx
西装	xhla
情况	xhlk
西部	xhlk
定产	xhlp
寒冷	xhlr
西边	xhlz
党政机关	xhmb
家门	xhmd
耀眼	xhmi
光标	xhmo
穿梭	xhms
寡妇	xhni
恰到好处	xhnw
怀抱	xhod
情报	xhoe
定局	xhog
宣扬	xhog
富饶	xhoh
宣布	xhoj
宣誓	xhoj
情操	xhok
西南	xhok
定居	xhoo
穿插	xhop
家属	xhop
情势	xhop
富有	xhou
寡	xhpd
西周	xhpg
定向	xhpk
定稿	xhpm
宣称	xhpm
窒息	xhpm
家	xhpn
西瓜	xhpp
穿行	xhpr
定律	xhpr
西德	xhpr
定时	xhrc
怀	xhrd
光照	xhrd
怀念	xhrd
定影	xhre
光景	xhre
家禽	xhre
情景	xhre
宣传	xhre
恒	xhrh
宣	xhrh
定量	xhrh
恒量	xhrh
家伙	xhrh
定位	xhrl
定做	xhro
家人	xhrp
情人	xhrp
定价	xhrr
光明	xhru
寒假	xhrw
定罪	xhsa
寒流	xhse
光波	xhsg
宁波	xhsg
光滑	xhsk
光洁	xhso
寒潮	xhso
恒温	xhsr
室	xhst
窒	xhst
光源	xhsv
光泽	xhsy
西洋	xhsy
愫	xhtj
情境	xhtl
穿戴	xhtt
情	xhtu
西服	xhue
宁愿	xhvb
情愿	xhvb
情感	xhvh
家长	xhvp
舛	xhwa
寒冬	xhwd
西文	xhwd
窀	xhwg
富民	xhwh
家务	xhwl
桀	xhwm
穿	xhwp
定理	xhwr
家乡	xhww
室外	xhxa
定性	xhxf
光辉	xhxh
恒定	xhxh
西宁	xhxh
灾情	xhxh
西安	xhxn
懒惰	xhxo
灾害	xhxs
定额	xhxw
宦官	xhxw
灾难	xhya
光谱	xhyb
宣言	xhyd
宣讲	xhye
穿着	xhym
宣读	xhyo
情调	xhyp
情谊	xhyx
情趣	xhze
穿孔	xhzg
穿越	xhzh
定子	xhzw
光子	xhzw
塞子	xhzw
寨子	xhzw
当	xi
当前	xibh
当天	xier
当选	xifa
当年	xifh
慨	xigg
恨	xign
当面	xihp
当初	xiid
当即	xiig
当中	xika
窘	xikd
当权	ximy
当局	xiog
当真	xiok
当兵	xipa
当	xiph
当日	xira
当时	xirc
当今	xird
当晚	xird
当作	xirf
当代	xirh
当做	xiro
当众	xirr
当场	xitg
当地	xitg
当月	xiup
当然	xixd
当心	xixd
当家	xixh
当差	xiyg
帘	xj
帘	xjda
忻	xjda
党纪国法	xjks
名	xk
愦	xkab
忡	xkad
弊	xkbc
悒	xkbd
瞥	xkbm
蹩	xkbr
名单	xkbr
鳖	xkbu
敝	xkbw
惘	xkbw
憋	xkbx
名学	xkdb
名誉	xkdb
怏	xkdd
窝头	xkdd
名	xkdh
名义	xkdi
家喻户晓	xkdr
尚未	xkea
心中无数	xkeb
弊病	xkgl
恫	xkhk
窜	xkka
敞口	xkka
名贵	xkka
党中央	xkkd
宫	xkkg
愕	xkkg
敞开	xkkh
氅	xkkm
尚	xkkp
瞥见	xkkp
窝	xkkr
敞	xkkw
弊端	xklo
名次	xklq
名目	xkma
悃	xkmh
憋闷	xkmx
心中有数	xkob
宫殿	xkoc
宙	xkoh
名声	xkoh
名士	xkoh
名册	xkpg
名称	xkpm
名利	xkpm
宫廷	xkpo
憋气	xkqp
名气	xkqp
宜昌	xkrr
惧	xksb
宜	xksg
名胜	xkuf
蹩脚	xkut
尚书	xkwg
惧怕	xkxb
名家	xkxh
名堂	xkxt
名额	xkxw
名字	xkxz
名言	xkyd
名词	xkyg
实践证明	xkyr
穷	xl
寝	xlay
穷苦	xlco
穷	xldp
穷困	xlkm
宰相	xlmm
宰	xlog
窨	xlrd
穷人	xlrp
憧	xlrt
憧憬	xlxr
外部设备	xlyw
怵	xmdd
宋	xmgn
栗	xmhn
当机立断	xmlb
憷	xmmr
悯	xmwd
栗子	xmzw
要	xn
要紧	xnaa
要点	xnah
案卷	xnbe
要道	xnbh
恰如其分	xncb
牢房	xndo
牢靠	xnfa
安放	xnfw
牢	xnga
安庆	xngd
安	xngh
要强	xngk
要求	xnhg
要	xnhh
要素	xnht
牢固	xnko
安装	xnla
案	xnmg
要好	xnnz
安排	xnoa
要挟	xnoh
安慰	xnoo
要饭	xnop
安徽	xnpr
要得	xnpr
要么	xnps
要领	xnrd
案例	xnrh
要命	xnrh
案件	xnrn
要件	xnrn
要人	xnrp
安全	xnrw
安置	xnso
要地	xntg
安培	xntl
要脸	xnur
安心	xnxd
安定	xnxh
安宁	xnxh
案情	xnxh
牢牢	xnxn
要害	xnxs
牢记	xnyj
案子	xnzw
宗	xo
忧虑	xoah
宠爱	xoat
怩	xobd
宗旨	xobr
愤	xocb
飘荡	xocs
飧	xodd
剽	xodh
宏大	xodh
票房	xodo
宠儿	xoep
飘动	xoes
恢复	xofr
宠	xogd
忧	xogd
宗	xogd
窦	xogd
宕	xogh
惰	xogu
恢	xohd
票	xohd
情有可原	xohv
怖	xojd
恺	xojd
飘	xoji
慎	xokb
怙	xokd
党支部	xolk
情报检索	xomo
愤怒	xony
飘扬	xoog
忧郁	xoou
慎重	xoph
忧愁	xopm
瓢	xopp
忧伤	xorf
宏伟	xorh
愤懑	xosc
飘流	xose
宏	xosg
飘渺	xosm
宗派	xosp
宗法	xost
宗教	xotp
悖	xotz
宥	xoug
窟	xowo
愤然	xoxd
窟窿	xoxe
惰性	xoxf
愤恨	xoxi
愤慨	xoxi
忮	xoyd
宏观	xoyk
少	xp
宾	xpab
少爷	xpbi
少数	xpbm
覆盖	xpbw
少	xpd
窆	xpdn
窗户	xpdo
夕阳	xper
宾主	xpet
少年	xpfh
究	xpgd
宄	xpgg
惆	xpgk
覆灭	xphh
省事	xphk
恬静	xpht
多种经营	xpjc
窗口	xpka
懊	xpkd
窗	xpkh
少见	xpkp
劣	xpld
窕	xpld
究竟	xplr
省	xpmd
恤	xpmd
愀	xpmh
湫	xpmh
悸	xpmz
少女	xpnw
懊丧	xpob
忏	xpod
恬	xpok
劣势	xpop
少有	xpou
宾馆	xpox
省委	xppm
窳	xppn
省得	xppr
宅	xpqg
省份	xprb
省会	xpre
常委会	xpre
党委会	xpre
少量	xprh
覆	xprw
覆没	xpsj
窗台	xpsk
省去	xpts
省城	xptv
省略	xptw
省长	xpvp
夕	xpwd
懊恼	xpxe
忏悔	xpxf
窗帘	xpxj
多种多样	xpxm
安徽省	xpxp
惆怅	xpxv
宾客	xpxw
少许	xpyf
窗子	xpzw
窃	xqdd
突	xqdd
忾	xqdg
突变	xqea
突击	xqeo
窃取	xqey
突围	xqkh
窃听	xqkj
突破	xqog
突出	xqwa
突然	xqxd
突起	xqzj
审	xrag
审判	xrbe
审美	xrbw
宿营	xrct
怜	xrdd
容忍	xrdd
惕	xrdp
悍	xrea
憬	xrex
安全生产	xrfl
惺	xrft
宴席	xrgc
怆	xrgg
恰巧	xrgh
宿	xrhb
愉	xrhd
怛	xrhd
窬	xrhd
恰	xrhk
容纳	xrjk
容	xrkd
寓	xrkd
容器	xrkk
宣传部	xrlk
寓意	xrlr
审阅	xrmb
愠	xrmd
窠	xrmd
审核	xrme
审问	xrmk
审查	xrmr
宴	xrng
恰好	xrnz
审批	xrob
光明磊落	xroc
覃	xroh
容貌	xrpd
容积	xrpm
寓所	xrpp
容易	xrrd
宿舍	xrre
宴会	xrre
容量	xrrh
光明日报	xrro
慢	xrsy
悝	xrtd
审理	xrwr
怜惜	xrxc
慢性	xrxf
审定	xrxh
恰当	xrxi
怜悯	xrxm
慢慢	xrxr
恰恰	xrxr
愉快	xrxw
审议	xryd
寓言	xryd
容许	xryf
审讯	xryg
宴请	xryh
害	xs
割	xsad
害	xsak
豁	xsak
割断	xsbm
惨白	xsbp
赏罚分明	xsbr
悛	xsbw
豁免	xsdk
惨	xsdp
愣	xsfd
惨痛	xsgl
寰	xshi
惨遭	xshk
割裂	xshx
割线	xsje
怡	xskd
惨叫	xskg
惨状	xsla
心满意足	xslk
惨祸	xsok
割据	xsoo
惨重	xsph
惨淡	xssh
害臊	xsuk
害虫	xsva
害处	xswa
害怕	xsxb
惨案	xsxn
割让	xsya
害羞	xsyw
党	xt
党龄	xtar
党籍	xtas
掌舵	xtax
掌管	xtax
常数	xtbm
悻	xtbo
恃	xtcd
常态	xtdd
尘	xtdh
鄄	xteh
常规	xter
尝	xtes
党旗	xtff
常年	xtfh
党羽	xtgl
党政	xtha
甄	xthd
常青	xtht
党风	xtji
党纪	xtjj
党纲	xtjk
党组	xtjk
赏	xtkb
党员	xtkb
党	xtke
裳	xtki
常	xtkj
棠	xtkm
掌	xtko
常见	xtkp
党内	xtkr
堂	xtkt
党章	xtlr
党校	xtme
掌柜	xtmh
掌声	xtoh
掌握	xtoo
忱	xtpg
常委	xtpm
党委	xtpm
常量	xtrh
常人	xtrp
怯	xtsd
党派	xtsp
常温	xtsr
尘土	xtth
尘埃	xtts
常用	xtua
恽	xtvd
常务	xtwl
常备	xtwt
党外	xtxa
党性	xtxf
常常	xtxt
尝试	xtyh
常识	xtyk
赏识	xtyk
削	xu
逍遥	xuaf
懈	xudn
削	xudp
懦夫	xuer
懦弱	xugl
削弱	xugl
懦	xuha
名胜古迹	xuoe
小朋友	xuoy
肖	xuph
肖像	xurd
家用电器	xurk
实用性	xuxf
逍	xuzp
憾	xv
怅	xvdn
宸	xven
憾事	xvhk
憾	xvhx
惭	xvjd
恹	xvqd
惭愧	xvxb
怅惘	xvxk
快	xw
寤	xwak
寐	xwam
宝贝	xwba
宝藏	xwcv
快	xwdd
额头	xwdd
当务之急	xwdd
宝	xwdg
客户	xwdo
额角	xwdu
官职	xwek
客运	xwes
官方	xwfd
额度	xwgc
官司	xwgh
宝座	xwgr
官府	xwgr
宝库	xwgv
快攻	xwgw
惴	xwha
官	xwhh
快速	xwhk
逭	xwhz
宝贵	xwka
额	xwkb
官员	xwkb
恪	xwkd
客	xwkg
寥	xwlp
快门	xwmd
宝山	xwoa
宝石	xwoh
官兵	xwpa
常务委员会	xwpr
快乐	xwpw
客气	xwqp
官僚	xwrd
宝剑	xwrh
惯例	xwrh
客体	xwrm
客人	xwrp
窈	xwsl
快活	xwsp
宝塔	xwtc
忸	xwtd
官场	xwtg
惯用	xwua
客车	xwvh
客厅	xwvh
快车	xwvh
惯	xwwb
额外	xwxa
惯性	xwxf
额定	xwxh
快要	xwxn
快慢	xwxr
客观	xwyk
多分	xxbd
多半	xxbe
多数	xxbm
察觉	xxdb
多	xxdd
穸	xxdd
察	xxdo
额外负担	xxdo
多变	xxea
惊心动魄	xxeb
多亏	xxeg
多于	xxeg
西安市	xxej
西宁市	xxej
多方	xxfd
多年	xxfh
剜	xxgd
宛	xxgg
夤	xxhb
恍	xxhe
多事	xxhk
多嘴	xxka
惝	xxkk
多次	xxlq
多边	xxlz
恰恰相反	xxmp
多样	xxmy
宛如	xxnk
突然袭击	xxoe
察看	xxpe
多种	xxpm
多么	xxps
多余	xxre
甯	xxua
悄	xxud
心安理得	xxwp
小心翼翼	xxww
惋惜	xxxc
多心	xxxd
恍然	xxxd
恍惚	xxxd
惋	xxxg
多情	xxxh
多少	xxxp
多多	xxxx
悄悄	xxxx
宵	xxyg
多孔	xxzg
怪	xy
宏观世界	xyct
怿	xyea
詈	xyhh
怪事	xyhk
怪物	xynd
怪罪	xysa
审计署	xyst
怪	xytd
字符	xzar
字幕	xzcr
字句	xzdk
字迹	xzep
字	xzgh
字库	xzgv
字面	xzhp
字画	xzht
字典	xzkc
字型	xzkd
字号	xzkh
字形	xzkp
字眼	xzmi
字母	xzmw
字样	xzmy
字据	xzoo
字体	xzrm
也	y
让	ya
让步	yaaa
醭	yaad
难点	yaah
难受	yaat
难关	yabe
难道	yabh
酹	yach
难过	yacz
讣	yadg
难	yadh
难免	yadk
难为	yadl
难于	yaeg
难忘	yaew
谖	yaey
谣	yafg
难度	yagc
难以	yagd
谁	yagh
谯	yahg
让	yahh
醮	yahh
醵	yahn
谑	yahw
让给	yajr
难听	yakj
计算机	yamj
难看	yape
难得	yapr
谣传	yare
难题	yarh
难保	yark
诽	yass
难堪	yatc
难处	yawa
难民	yawh
难怪	yaxy
谣言	yayd
诽谤	yaye
说	yb
谦虚	ybah
说笑	ybap
谐	ybbb
说道	ybbh
酚	ybdh
善良	ybdi
善于	ybeg
谦	ybhb
谫	ybhd
鄯	ybhe
善	ybhk
谥	ybhm
谱	ybhr
谱表	ybht
说	ybke
善意	yblr
眯	ybmz
醚	ybmz
谜	ybmz
说好	ybnz
谐振	ybov
诣	ybrg
酯	ybrh
说明	ybru
讼	ybsg
说法	ybst
谱写	ybth
说教	ybtp
说服	ybue
说理	ybwr
谦让	ybya
难道说	ybyb
说谎	ybyc
谜语	ybyh
说话	ybyp
谦逊	ybzx
对	yc
对策	ycah
对等	ycat
对比	ycbb
对数	ycbm
对	ycdd
艰苦奋斗	ycdd
对象	ycdk
对角	ycdu
对联	yceb
谎	yceg
对于	yceg
酣	yceh
谋	ycem
谋取	ycey
对方	ycfd
谋生	ycft
讨	ycgd
对应	ycgd
谋划	ycgd
酎	ychd
谋求	ychg
谍	ychm
对面	ychp
醋	ychr
谨	ycht
谋杀	ycih
对内	yckr
对准	ycla
对立	ycld
对本	ycmh
讨好	ycnz
对抗	ycoe
对局	ycog
诺	ycok
对手	ycop
对峙	ycot
对称	ycpm
对质	ycpp
对待	ycpr
对付	ycrc
谟	ycrd
对照	ycrd
醛	ycrw
对流	ycse
谌	ycsw
谋略	yctw
对虾	ycva
讨厌	ycvq
对外	ycxa
怼	ycxd
对光	ycxh
谨慎	ycxo
谎言	ycyd
诺言	ycyd
对话	ycyp
谎话	ycyp
讨论	ycyr
醋酸	ycys
议	yd
羊羔	ydbw
酬劳	ydct
酞	yddh
酌	yddh
议院	ydex
酿造	ydfa
讠	ydg
谧	ydgm
言	ydhh
议事	ydhk
议	ydig
诌	ydig
诤	ydig
羊群	ydik
酿	ydin
谄	ydjg
酬金	ydjp
议员	ydkb
谗	ydkd
诏	ydkg
议决	ydlw
询问	ydmk
羊毛	ydmp
叉	ydn
庐山	ydoa
谝	ydoc
庐	ydop
言之有理	ydow
酬	ydpa
羊	ydph
议程	ydpm
议和	ydpm
言行	ydpr
议会	ydre
询	ydrg
议题	ydrh
议价	ydrr
酿酒	ydsy
诡	ydvg
蚤	ydvn
议长	ydvp
谵	ydvy
议案	ydxn
难解难分	ydyb
言词	ydyg
言语	ydyh
酬谢	ydyo
诡计	ydyo
言论	ydyr
议论	ydyr
讲	ye
讦	yeag
酐	yeah
讲师	yeap
谤	yebf
谛	yebj
谪	yebk
邓	yeda
讲学	yedb
讲义	yedi
讲解	yedu
谅解	yedu
讲习	yegl
讲座	yegr
讲求	yehg
该死	yehx
谅	yekx
醇	yekz
谆	yekz
讲述	yemd
讲授	yeoa
欢天喜地	yeot
讲	yepa
讲稿	yepm
醉	yero
谇	yero
酝	yesh
讲台	yesk
醯	yesm
讲演	yesx
该	yewr
讲理	yewr
讲究	yexp
讲堂	yext
酝酿	yeyd
诹	yeyg
讲话	yeyp
讲课	yeyr
许	yf
诈	yfae
诜	yfae
酢	yfae
酰	yfae
酷	yfak
诰	yfak
酷爱	yfat
访	yfgg
讫	yfgg
许可	yfhk
酷刑	yfkd
诈骗	yfmd
诲	yfmg
酶	yfmh
访问	yfmk
许	yfog
许多	yfxx
许诺	yfyc
差	yg
酏	ygag
醑	ygau
戏	ygdd
词句	ygdk
讧	yggh
词库	yggv
词	yghk
醣	ygik
差错	ygjc
词组	ygjk
差距	ygka
词典	ygkc
戏曲	ygkc
差别	ygkl
翔	ygll
诩	ygll
讯问	ygmk
讯	ygog
戏剧	ygoo
差	ygph
差异	ygsc
词汇	ygsh
戏法	ygst
戏弄	ygwc
差劲	ygwd
差额	ygxw
词语	ygyh
请	yh
证	yhag
诬	yhah
试点	yhah
语	yhak
酽	yhav
酉	yhaw
试管	yhax
评比	yhbb
订购	yhbd
评判	yhbe
谈判	yhbe
证券	yhbe
评	yhbo
诫	yhcd
诬蔑	yhcs
语句	yhdk
诬陷	yhed
评选	yhfa
诬告	yhfa
试制	yhfh
试	yhgd
订	yhgg
酊	yhgh
试飞	yhgp
讳	yhha
谈	yhhg
请求	yhhg
谈到	yhhs
讴	yhiw
评级	yhjp
试销	yhjx
谏	yhkb
酾	yhkd
诃	yhkg
试图	yhkw
订立	yhld
语音	yhlr
证章	yhlr
订阅	yhmb
请问	yhmk
试问	yhmk
试想	yhmm
试验	yhmr
试样	yhmy
订婚	yhnp
请示	yhoh
评剧	yhoo
证据	yhoo
试探	yhot
试种	yhpm
诼	yhpn
试行	yhpr
语气	yhqp
试题	yhrh
试件	yhrn
证件	yhrn
评估	yhro
证人	yhrp
订货	yhrq
评价	yhrr
请坐	yhrr
证明	yhru
请假	yhrw
语汇	yhsh
请教	yhtp
请	yhtu
试用	yhua
请愿	yhvb
语文	yhwd
语录	yhwe
证书	yhwg
讶	yhwp
试剂	yhwp
谮	yhwr
讵	yhww
诓	yhww
谈心	yhxd
证实	yhxd
评定	yhxh
评审	yhxr
请客	yhxw
评议	yhyd
语言	yhyd
评语	yhyh
谈话	yhyp
语调	yhyp
评论	yhyr
谈论	yhyr
艰	yi
艰苦	yico
艰险	yier
艰	yign
艰巨	yihw
酗酒	yisy
酗	yiwa
艰难	yiya
设	yj
讥笑	yjap
配料	yjbm
记账	yjbv
诉苦	yjco
配色	yjdb
诉	yjdg
配套	yjdh
配方	yjfd
设施	yjff
配制	yjfh
讥	yjgg
记	yjgg
配	yjhg
讽刺	yjhj
记事	yjhk
讽	yjig
记号	yjkh
设立	yjld
记述	yjmd
设想	yjmm
欢欣鼓舞	yjof
配种	yjpm
记得	yjpr
记住	yjre
谀	yjrg
配合	yjrh
配件	yjrn
配置	yjso
设置	yjso
设法	yjst
记者	yjtp
记载	yjtv
记录	yjwe
配备	yjwt
设备	yjwt
记性	yjxf
记忆	yjxg
诉说	yjyb
诉讼	yjyb
设	yjyg
讥讽	yjyj
设计	yjyo
观	yk
观点	ykah
谴	ykaz
识	ykbg
醴	ykcd
误解	ykdu
观望	ykeg
误	yker
观摩	ykgm
酮	ykhk
误事	ykhk
谴责	ykht
谔	ykkg
诅咒	ykkk
识别	ykkl
识破	ykog
对内搞活	ykos
观看	ykpe
观	ykpg
观念	ykrd
误会	ykre
讷	ykrg
观众	ykrr
观测	yksb
诅	yksg
观感	ykvh
酲	ykwh
观赏	ykxt
观察	ykxx
识字	ykxz
误差	ykyg
误认	ykyr
劝	yl
劝	yldp
劝解	yldu
劝阻	ylek
劝告	ylfa
醅	ylkh
谚	ylpp
谘	ylqk
谙	ylrg
劝说	ylyb
谚语	ylyh
着	ym
着急	ymdi
着陆	ymee
谰	ymhb
着火	ymhd
着眼	ymmi
着想	ymmm
着手	ymop
调查研究	ymox
着	ymph
着重	ymph
着实	ymxd
鸡	yn
诸如此类	ynab
诛	ynbg
鸡	yndh
鸡蛋	ynga
善始善终	ynyj
读	yo
计策	yoah
计算	yoam
计数	yobm
谢	yocg
计	yoga
讪	yoga
读	yogd
计划	yogd
诙	yohg
诘	yohk
谢绝	yojd
诂	yokg
酤	yokh
醢	yokm
谳	yokq
醐	yoku
读物	yond
羰	yooh
计委	yopm
计量	yorh
读者	yotp
计较	yove
读书	yowg
诙谐	yoyb
谢谢	yoyo
话	yp
训	ypaa
调频	ypaa
话筒	ypak
调集	ypam
误入歧途	ypar
诞	ypaz
调料	ypbm
调节	ypcg
调解	ypdu
调动	ypes
调运	ypes
调制	ypfh
诞生	ypft
调度	ypgc
诋	ypgd
羝	ypgd
调	ypgk
调皮	ypgp
醺	yphh
调整	yphk
诱惑	yphk
调幅	ypjh
训练	ypjh
调遣	ypka
调味	ypke
话音	yplr
酥	ypmh
诿	ypmn
诱	ypmp
调查	ypmr
调换	ypod
话	ypok
调研	ypok
话剧	ypoo
诟	yppk
调和	yppm
调入	yppn
话题	yprh
诱导	ypsc
酥油	ypsk
调用	ypua
诞辰	ypve
调出	ypwa
调剂	ypwp
调谐	ypyb
话说	ypyb
调试	ypyh
话语	ypyh
调配	ypyj
调子	ypzw
欢	yq
欢笑	yqap
欢送	yqbe
欢	yqdn
欢度	yqgc
欢欣	yqjq
欢呼	yqkp
欢喜	yqod
欢迎	yqpg
欢乐	yqpw
欢腾	yqub
诳	yqwg
欢快	yqxw
论	yr
论点	yrah
论战	yrah
醌	yrbb
论	yrbg
论断	yrbm
诊断	yrbm
羚	yrdd
认为	yrdl
谒	yrdw
羯	yrdw
谂	yrdx
酴	yrex
醒	yrft
认	yrgn
谕	yrhd
认可	yrhk
醍	yrhr
讨价还价	yrhr
认错	yrjc
论述	yrmd
课	yrmg
课本	yrmh
课间	yrmr
认真	yrok
论据	yroo
课程	yrpm
诊	yrpp
诊所	yrpp
认得	yrpr
讹	yrqg
课时	yrrc
谶	yrrd
课余	yrre
课题	yrrh
认清	yrsh
认出	yrwa
课文	yrwd
论文	yrwd
诠	yrwg
课外	yrxa
认定	yrxh
醒悟	yrxh
谈何容易	yrxr
课堂	yrxt
谩	yrxy
论证	yryh
认识	yryk
论调	yryp
酸	ys
诔	ysab
酸	ysbw
羧	ysbw
诶	ysfd
酸度	ysgc
难能可贵	yshk
诒	yskg
酸洗	yssf
酸性	ysxf
诗	yt
诗篇	ytad
谡	ytbw
诗	ytcg
诗句	ytdk
诗歌	ythk
酵母	ytmw
圣	ytnh
诸如	ytnk
诸	ytpr
酵	ytpz
诸位	ytrl
圣人	ytrp
诗人	ytrp
诸侯	ytrw
诖	yttg
圣地	yttg
谓	ytug
诨	ytvg
诗文	ytwd
圣诞	ytyp
诚	yv
诚	yvgd
诚恳	yvig
诚意	yvlr
诚挚	yvop
诚然	yvxd
诚实	yvxd
诚心	yvxd
又	yw
诎	ywao
羟基	ywcs
诀	ywdg
羟	ywdg
谲	ywdk
诵	ywdo
羞耻	ywea
酪	ywkh
谬	ywlp
醪	ywlp
又	ywn
羞涩	ywsd
羞	ywtp
羞辱	ywve
羞愧	ywxb
又要	ywxn
谬论	ywyr
谭	yx
酡	yxbh
诗情画意	yxhl
对外经济贸易	yxjr
对外开放	yxkf
酩	yxkh
谊	yxks
诧	yxpq
对外贸易	yxpr
谭	yxro
诧异	yxsc
谠	yxte
诮	yxug
酌情处理	yxww
谨小慎微	yxxp
诚心诚意	yxyl
双	yy
双关	yybe
双	yydn
译	yyea
双方	yyfd
详	yyga
详细	yyjt
桑叶	yyko
双边	yylz
桑树	yymy
双层	yyoe
双打	yyoh
译码	yyom
详尽	yyon
双手	yyop
双重	yyph
译文	yywd
详情	yyxh
颡	yyyb
桑	yyym
叠	yyys
在	z
赴	za
赴	zadn
超	zd
超龄	zdar
超过	zdcz
超速	zdhk
趋	zdin
超级	zdjp
超员	zdkb
超	zdkn
超产	zdlp
超音	zdlr
超声	zdoh
趋势	zdop
超支	zdoy
超重	zdph
趋向	zdpk
超导	zdsc
孢	zdst
超载	zdtv
超脱	zdub
超出	zdwa
辶	zdwn
超额	zdxw
超越	zdzh
赶	ze
赶紧	zeaa
赶上	zeah
赶	zean
承受	zeat
承蒙	zect
承包	zeds
赶路	zeka
趣味	zeke
赶回	zekk
承办	zelb
承揽	zeoa
承接	zeol
承担	zeor
承重	zeph
承载	zetv
承	zewn
孩	zewr
赶忙	zexe
孤陋寡闻	zexm
赶快	zexw
趣	zeyn
承认	zeyr
赶超	zezd
赶走	zezh
孩子	zezw
趱	zfab
孔	zg
赳	zgan
孔隙	zgex
孔径	zgpr
孔	zgt
孔雀	zgxa
走	zh
走	zhah
越过	zhcz
走动	zhes
越	zhgd
走廊	zhgd
走路	zhka
走开	zhkh
越南	zhok
越剧	zhoo
孙百川	zhpa
走向	zhpk
走私	zhpm
走狗	zhqd
越是	zhrh
趔	zhsd
走漏	zhso
越冬	zhwd
越发	zhwp
走访	zhyf
走读	zhyo
赵	zi
赵	zind
起	zj
起航	zjae
起点	zjah
起草	zjcr
起落	zjcs
起头	zjdd
起义	zjdi
超级大国	zjdk
起动	zjes
起先	zjfa
起床	zjgm
起飞	zjgp
起来	zjhb
起火	zjhd
起事	zjhk
起初	zjid
起跑	zjka
起跳	zjka
起吊	zjkj
起见	zjkp
起立	zjld
起毛	zjmp
起	zjng
起始	zjns
起誓	zjoj
起码	zjom
起居	zjoo
起身	zjop
起重	zjph
起伏	zjrq
起泡	zjsd
起源	zjsv
起劲	zjwd
起家	zjxh
起诉	zjyj
趄	zksn
趑	zlqn
孟	zm
孟	zmhh
勐	zmlh
趁热打铁	zooj
孤	zp
孤单	zpbr
孤儿	zpep
孤立	zpld
孤	zppn
孤独	zpqv
孤寂	zpxa
趁	zr
趁机	zrmj
趁势	zrop
趁	zrpp
趁早	zrro
孺	zu
孺	zuha
子	zw
子弟	zwbg
子弹	zwgb
子	zwgh
廴	zwn
子女	zwnw
孜	zwtn
子宫	zwxk
子孙	zwzx
孙	zx
逊色	zxdb
趟	zxkk
孙女	zxnw
孙	zxtd
逊	zxzt
孙子	zxzw
承认错误	zyjy
